госслужащий: госслужащим госслужащего госслужащие госслужащих госслужащему госслужащий госслужащими 
заниматься: заниматься занимается 
трейдинг: трейдинг трейдингом 
промой: промо 
увеличивать: увеличьте 
доход: доходах доход 
сообщество: сообществе сообществом сообщество 
инвестор: инвесторы инвестор инвесторов 
это: этим это 
работать: работает 
учебник: учебник 
сравнятор: сравнятор 
ипотека: ипотека 
кредитный: кредитная 
история: история 
тест: тесты 
дневник: дневники дневник 
трата: трат 
налоговый: налоговые налоговую налоговый 
вычет: вычет 
написать: написать 
инвестиция: инвестиций инвестиции инвестициями 
бизнес: бизнес бизнеса 
разбор: разборы 
закон: законов закона законах закону 
калькулятор: калькуляторы 
путешествие: путешествия 
медицина: медицина 
здоровье: здоровье 
недвижимость: недвижимость 
подкаста: подкасты 
видео: видео 
смотреть: смотреть 
сервис: сервисы 
расчет: расчеты 
закладка: закладки 
письмо: письма 
оставаться: оставайтесь 
деньги: деньгами деньги денег 
поток: потоки 
делать: делать 
вправе: вправе 
максим: максим 
спрашивать: спросил спрашивают 
профиль: профиль 
автор: автора 
писать: писали 
статья: статьи статьях 
информация: информации 
относиться: относится 
предпринимательский: предпринимательская предпринимательской 
деятельность: деятельностью деятельность деятельности 
торговать: торговать торгующим 
фьючерс: фьючерс фьючерсом фьючерсы фьючерсам фьючерсов фьючерса фьючерсами 
например: например 
индекс: индекс 
ртс: ртс 
станислав: станислав 
егоркин: егоркин 
юрист: юрист 
сожаление: сожалению 
однозначный: однозначного 
ответ: ответа ответах ответом 
ваш: вашей ваш ваши 
вопрос: вопрос вопросах 
запрещать: запрещены запрещено запрещена 
орган: органам органа органы 
власть: власти 
включая: включая 
суд: суд судов суды 
пока: пока 
сформировывать: сформировали 
позиция: позицию позиции позиция 
считаться: считаются считается 
который: который которые которых которая котором 
рисковать: рискует 
увольнять: уволенным уволить 
связь: связи 
утрата: утратой 
доверие: доверия 
направлять: направлена 
систематический: систематическое систематическая систематические 
получение: получение 
прибыль: прибыли прибыль 
должный: должна должен должны 
самостоятельный: самостоятельной 
осуществляться: осуществляться 
свой: свои свой 
риск: риск риски 
получать: получают получить получать получили 
использование: использования 
имущество: имуществе имущества имущество 
продажа: продажи 
товар: товаров товары 
выполнение: выполнения 
работа: работ работе работы 
оказание: оказания 
услуга: услуг услуги 
абз: абз 
п: п 
ст: ст 
гк: гк 
рф: рф 
предпринимательство: предпринимательством 
обычно: обычно 
создавать: создает создают 
юрлицо: юрлицо 
статус: статуса статус 
ипать: ип 
становиться: становятся 
учет: учетом учет 
качество: качестве 
самозанимать: самозанятого 
признавать: признана признал признать 
человек: человеку человек 
она: ею 
трейдер: трейдеры трейдера 
правило: правило правилам правил правила 
регулярно: регулярно 
покупать: покупает покупая покупать покупают 
продавать: продают продавая продает 
финансовый: финансовых финансовые финансовыми 
актив: активы активов активами 
производный: производными производные 
инструмент: инструменты инструментов инструментами 
поэтому: поэтому 
формально: формально 
соответствовать: соответствует 
признак: признакам 
биржа: бирже биржу биржи 
такой: таким такое таких такие такую 
сложно: сложно сложнее 
отличаться: отличается 
повышенный: повышенным 
количество: количеством количество 
сделка: сделкам сделок сделки 
меньший: меньшим 
срок: срок сроком 
владение: владения владение 
проводить: провести 
четкий: четкой четкую 
граница: границу 
этот: этими 
действие: действиями 
непросто: непросто 
предполагать: предположить 
день: день 
акция: акциями акции акций 
один: одна одно одной 
компания: компании компаний 
сей: сих 
пора: пор 
удаваться: удалось 
находить: найти 
решение: решение 
торговля: торговлю торговле торговлей 
форекс: форексе 
все: всем 
сделать: сделать 
вывод: вывод 
крайний: крайней 
мера: мере 
некоторые: некоторым некоторых 
случай: случаях случае 
рассматривать: рассматривая рассматривают 
совершение: совершение 
гражданин: гражданином 
рынок: рынке рынках рынка 
форма: форму форма 
разница: разница 
спекулятивный: спекулятивной 
сторона: сторон стороной стороны сторонами 
сайт: сайте сайтом 
минтруд: минтруда 
соцразвитие: соцразвития 
методичка: методичке методичка 
мочь: могу могут 
ценный: ценных ценными ценные ценная 
бумага: бумагами бумагах бумаги бумаг бумага 
сказать: сказано 
брокер: брокер брокера 
инвестиционный: инвестиционная 
оказывать: оказывает 
посреднический: посреднические 
следовать: следует 
речь: речь 
именно: именно 
другой: другие других другими 
вид: видах 
определенный: определенные 
ограничение: ограничения 
богатеть: богатеть 
главный: главная главные 
материал: материалы материалов 
обо: обо 
влиять: влияет 
жизнь: жизнь 
почта: почте 
среда: средам 
суббота: субботам 
бесплатно: бесплатно 
подписываться: подписаться 
какой: какие каким 
возникать: возникали возникать 
конфликт: конфликта конфликте конфликту конфликт 
интерес: интересов 
значит: значит 
личный: личная 
заинтересованность: заинтересованность 
мешать: мешать 
противодействие: противодействии 
коррупция: коррупции 
законодательство: законодательстве законодательство 
владеть: владеть 
пользоваться: пользоваться 
иностранный: иностранная иностранные иностранных иностранным иностранными иностранной 
число: числе 
контракт: контракта 
нерезидент: нерезидентом нерезидент нерезидентов 
структура: структура структурой 
чч: чч 
запрет: запрета запрете запрет 
отдельный: отдельных отдельным 
категория: категориям 
лицо: лиц 
иметь: иметь 
счет: счет счета счетах 
банк: банк банках 
кто: кому кого 
зависеть: зависит 
место: места мест 
должность: должностей должности 
список: списки 
федеральный: федеральных 
также: также 
приказ: приказах 
конкретный: конкретного конкретное конкретной конкретным 
министерство: министерствам 
служба: службе службы службам 
далее: далее 
многий: многих 
касаться: касается 
упоминать: упомянутые упомянутой 
вы: вами 
вряд: вряд 
приводить: привести приведенной 
отличие: отличие 
дело: дело делам 
входить: входят 
депозитарный: депозитарные 
расписка: расписки 
примерно: примерно 
цена: цена 
отражать: отражает 
состояние: состояние состоянию 
больший: большей 
часть: части 
российский: российского российские российскими 
определять: определить 
являться: является 
нереально: нереально 
август: августа 
год: лет году года 
мосбиржа: мосбиржа 
допускать: допускать допустила 
торги: торгам торгов 
срочный: срочном 
страна: стран 
вполне: вполне 
оказываться: оказаться 
проблема: проблема проблемой проблему проблемы проблем проблеме 
возможный: возможны возможных 
сложность: сложности 
высоко: выше 
отмечать: отмечено 
госорган: госоргана 
разрешать: разрешено 
они: ими 
распространяться: распространяются распространяться распространяется 
прямой: прямого 
дословно: дословно 
указывать: указывают указано 
приобретение: приобретении 
фьючерсный: фьючерсного 
необходимо: необходимо 
учитывать: учитывать 
распространять: распространяемые 
гражданский: гражданского 
служащий: служащего 
антикоррупционный: антикоррупционные 
стандарт: стандарты 
частность: частности 
требование: требование 
предотвращение: предотвращении 
урегулирование: урегулировании 
прямо: прямо 
косвенно: косвенно 
следствие: следствие 
нарушение: нарушение нарушения 
получаться: получается 
мнение: мнению мнение 
принцип: принципе 
указание: указание 
лишать: лишено 
смысл: смысла 
сам: сами 
непонятно: непонятно 
активно: активно 
любой: любом любые 
обязательный: обязательна 
проигнорировать: проигнорировать 
снижать: снизить 
евгений: евгений 
шепелев: шепелев 
частный: частный 
определение: определение 
кодекс: кодекса 
кажется: кажется 
расплывчатый: расплывчатым 
подводить: подвести 
вне: вне 
слышать: слышал 
ситуация: ситуации ситуациях 
методический: методические 
устранять: устраняют 
взгляд: взгляд 
логика: логика 
применяться: применяется 
внутридневный: внутридневной 
операция: операции 
иначе: иначе 
разный: разными 
биржевой: биржевых биржевыми 
бывать: бывает 
разделять: разделить 
понятие: понятия 
однако: однако 
факт: факт 
сотрудник: сотрудники 
посчитать: посчитают 
трактовать: трактовать 
просто: просто 
перестраховываться: перестраховаться 
хватить: хватить 
защищаться: защититься 
претензия: претензий 
рекомендовать: рекомендую 
уменьшать: уменьшить 
частота: частоту 
оборот: оборот 
производить: производить 
впечатление: впечатление впечатления 
слишком: слишком 
активный: активного 
портфель: портфеле 
показываться: показаться 
подходить: подходящими 
стоять: стоит 
пай: паями 
фонд: фондов 
внутри: внутри 
особенно: особенно 
важно: важно 
декабрь: декабря 
дата: дату 
принадлежащий: принадлежащие 
декларация: декларации 
лишний: лишнее лишний 
обсуждать: обсуждать 
коллега: коллегами 
публичный: публичном 
пространство: пространстве 
соцсеть: соцсетях 
итог: итоге 
воздерживаться: воздержаться 
находиться: находитесь 
госслужба: госслужбе 
хотя: хотя 
сокращать: сократить 
минимум: минимума 
позволять: позволит 
отрицать: отрицать 
систематичность: систематичность 
инвестировать: инвестировать 
осознавать: осознавать 
устаиваться: устоявшейся 
практик: практики 
расценивать: расценены 
узнавать: узнать 
особенность: особенностях 
наш: наши 
военнослужащий: военнослужащему 
зайти: зайти 
вылетать: вылететь 
инвесткопилка: инвесткопилкой 
супруг: супруг 
валюта: валюту 
читатель: читатели 
эксперт: эксперта эксперты 
отвечать: отвечают ответить 
задавать: задать задан 
тэг: тэги 
право: право 
дополнять: дополнен 
комментарий: комментарии 
проходить: проходят 
модерация: модерацию 
журнал: журнала 
добрый: добрый 
цб: цб 
фининструмент: фининструментами 
криптовалюта: криптовалютой 
эмитент: эмитенты 
аффилированность: аффилированности 
должно: должно 
пфи: пфи 
герой: герой 
согласный: согласен 
акт: актом 
установленный: установлен 
самый: самым 
пост: посте 
добавлять: добавить 
крипта: крипта 
анастасия: анастасия 
подразумевать: подразумеваете 
работник: работник работников 
занимать: занимающих 
государственный: государственных 
учреждение: учреждениях 
конкретно: конкретно 
алексей: алексей 
алферов: алферов 
утверждение: утверждением 
согласно: согласно 
национальный: национального 
клиринговый: клирингового 
центр: центра 
центральный: центральный 
контрагент: контрагент 
нкц: нкц 
берет: берет 
заключать: заключаемым 
участник: участниками 
ход: ходе 
выступать: выступая 
посредник: посредником 
продавец: продавцом продавец продавца 
каждый: каждого 
покупатель: покупателя покупателем 
заменять: заменяют 
договорный: договорные договорными 
отношение: отношения 
друг: друг другом 
соответствующий: соответствующими 
обязательство: обязательствами 
цк: цк 
московский: московской 
второй: второй 
резидент: резидент 
мошенник: мошенникам 
понадобиться: понадобились 
справка: справки 
репетитор: репетитор 
полагаться: полагался 
каникулы: каникулы 
платить: платил 
налог: налог налоги 
инвалидность: инвалидностью 
копить: копить 
балл: баллы 
уведомлять: уведомлять 
белоруссия: белоруссии 
поставлять: поставлять поставить 
работодатель: работодателю 
молодой: молодой 
хотеть: хочет 
оформлять: оформить 
машина: машину 
быть: будут 
сотрудничать: сотрудничают 
сосед: соседи 
заливать: залили 
дверной: дверную 
ручка: ручку 
замок: замок 
клей: клеем 
протест: протест 
ремонт: ремонта 
завещание: завещание 
ребенок: дети детей 
муж: мужа 
стоимость: стоимости 
здание: здание 
баланс: баланс 
рассказывать: расскажите 
багаж: багажом 
поездка: поездках 
косметичка: косметичка 
уход: уход 
чувствительный: чувствительной 
комбинированный: комбинированной 
кожа: кожей 
акна: акне 
последствие: последствия 
вносить: внесет 
доля: доли 
сколько: сколько 
вернуть: вернуть 
обучение: обучение 
отрабатывать: отработала 
целевой: целевому 
договор: договор договору 
составлять: составить 
процент: проценты 
популярный: популярное 
неделя: неделю 
посылка: посылка 
застревать: застряла 
таможня: таможне 
стаут: стауты 
гоза: гозе 
ламбик: ламбики 
пить: пить 
крафтовый: крафтовое 
пиво: пиво 
москва: москве 
жить: живет 
бали: бали 
зарплата: зарплатой 
въезд: въезда 
сербия: сербию 
россиянин: россиян 
поколение: поколение 
девяностый: девяностых 
труд: труда 
хороший: лучшие 
беспроводный: беспроводные 
колонка: колонки 
удачный: удачных 
модель: моделей 
директор: директор 
розничный: розничной 
сеть: сети 
поволжье: поволжье 
экономист: экономист 
дежурный: дежурный 
электромонтер: электромонтер 
новосибирск: новосибирске 
несколько: несколько 
тратить: тратила 
классный: классные 
apple: apple 
watch: watch 
вакансия: вакансии 
сообщать: сообщить 
проект: проекте 
контакт: контакты 
политика: политика 
конфиденциальность: конфиденциальности 
пользование: пользования 
выходить: выйти 
ао: ао 
лицензия: лицензия 
