работа: работа 
тинькофф: тинькофф 
журнал: журнала журнал журнале 
контентный: контентных 
проект: проекте проекты проектах 
промой: промо 
заклинание: заклинание 
бесплатный: бесплатную 
кредитка: кредитку 
fgo: fgo 
заказывать: заказать 
карта: карту 
учебник: учебник 
сравнятор: сравнятор 
сообщество: сообщество 
ипотека: ипотека 
кредитный: кредитная 
история: историй история 
тест: тесты 
дневник: дневники дневник 
трата: трат 
налоговый: налоговый 
вычет: вычет 
написать: написать 
инвестиция: инвестиций инвестиции 
бизнес: бизнес 
разбор: разборы 
закон: законов 
калькулятор: калькуляторы 
путешествие: путешествия 
медицина: медицина 
здоровье: здоровье 
недвижимость: недвижимость 
подкаста: подкасты 
видео: видео 
смотреть: смотреть 
сервис: сервисы 
расчет: расчеты 
закладка: закладки 
письмо: письма 
оставаться: оставайтесь 
деньги: деньгами деньгам деньги 
поток: потоки 
привет: привет 
восемь: восемь 
год: лет 
работать: работать работает 
человек: люди человек 
разумно: разумно 
относиться: относились 
вдохновляться: вдохновлялись 
финансовый: финансовые финансовой 
подвиг: подвиги 
просто: просто 
скучать: скучали 
начинать: начали 
небольшой: небольшого 
блог: блога блог 
это: это 
самый: самый 
большой: большой 
россия: россии 
который: который 
читать: читают 
миллион: миллионов 
месяц: месяц 
крутой: круче 
мы: нам 
постоянно: постоянно 
нужный: нужны 
новый: новые 
другой: другие 
редактор: редактор редакторы 
менеджер: менеджеры 
разработчик: разработчик разработчики 
дизайнер: дизайнер дизайнеры 
вакансия: вакансии 
младший: младший 
выпуск: выпуска 
короткий: коротких 
формат: форматов 
пользовательский: пользовательского 
контент: контента 
редакция: редакцию 
экономика: экономики 
статья: статей 
безопасность: безопасности 
ведущий: ведущий 
соцсеть: соцсетей 
cis: cis 
copywriters: copywriters 
мобильный: мобильное 
приложение: приложение 
продуктовый: продуктовый 
сторис: сторис 
главный: главный 
помощь: помощь 
продукт: продуктов продукта 
дебетовый: дебетовых 
мобайл: мобайл 
доля: долями 
главред: главред 
аналитик: аналитик 
сайт: сайта сайтом 
продюсер: продюсер 
событие: событий 
предприниматель: предпринимателях 
фронтендер: фронтендер 
приходить: приходите 
публиковать: публикуем 
подписываться: подписывайтесь 
шерять: шерьте 
чат: чат 
фултайм: фултайм 
хотеть: хотите 
писать: писать 
зарабатывать: зарабатывать 
прочитывать: прочитайте 
наш: наш 
гайд: гайд 
коллега: коллега коллег 
обращать: обращаем 
ваш: ваше 
внимание: внимание 
независимо: независимо 
должность: должности 
предлагать: предлагаем 
достойный: достойную 
белый: белую 
зарплата: зарплату 
ресурс: ресурсы 
реализация: реализации 
идея: идей 
уютный: уютный 
опенспейс: опенспейс 
возможность: возможность 
удаленный: удаленно 
удивительный: удивительных 
почитать: почитайте 
круто: круто 
офис: офис 
сообщать: сообщить 
проблема: проблеме 
контакт: контакты 
политика: политика 
конфиденциальность: конфиденциальности 
правило: правила 
пользование: пользования 
выходить: выйти 
ао: ао 
банк: банк 
лицензия: лицензия 
