подкаста: подкаст подкасты подкаста 
видео: видео 
учебник: учебник 
сравнятор: сравнятор 
сообщество: сообщество 
ипотека: ипотека 
кредитный: кредитная 
история: история 
тест: тесты 
дневник: дневники дневник 
трата: траты трат 
налоговый: налогового налоговый 
вычет: вычет 
написать: написать 
инвестиция: инвестиции 
бизнес: бизнес 
разбор: разборы 
закон: законов 
калькулятор: калькуляторы 
путешествие: путешествия 
медицина: медицина 
здоровье: здоровье 
недвижимость: недвижимость 
смотреть: смотреть 
сервис: сервисы 
расчет: расчеты 
закладка: закладки 
письмо: письма 
оставаться: оставайтесь 
деньги: деньгами деньги 
поток: потоки 
территория: территория 
свободный: свободная 
текст: текстов 
говорить: говорим 
показывать: показываем 
редакция: редакция 
б: б 
бюрократия: бюрократия 
кайф: кайф 
сколько: сколько 
стоять: стоит 
жизнь: жизни жизнь 
португалия: португалии 
александра: александра 
шкарина: шкарина 
хороший: лучших 
выпуск: выпусков 
таиланд: таиланд 
это: это 
девяностый: девяностых 
место: место 
солнце: солнцем 
почитать: почитать 
шоу: шоу 
очень: очень 
финансовый: финансово финансовую 
грамотный: грамотный 
успешно: успешно 
распоряжаться: распоряжаться 
мало: меньше 
думать: думать 
германия: германии 
анна: анна 
болотов: болотова 
тинькофф: тинькофф 
журнал: журнала 
год: год году года 
давать: дай 
бог: бог 
купить: куплю 
гном: гнома 
встречать: встречать 
новый: новый 
эмиграция: эмиграции 
медредакция: медредакция 
нужный: нужны 
таблетка: таблетки 
мочь: могу 
изменять: изменил 
наш: наши нашу 
финбезопасность: финбезопасности 
емкость: емкость 
обман: обманом 
вовлекать: вовлекают 
секта: секты 
аренда: аренда 
грузия: грузии 
скучный: скучная 
нормально: нормально 
психиатр: психиатр 
зависимость: зависимостях 
мы: нам 
подходить: подходите 
готовый: готовы 
выходить: выйти 
завтра: завтра 
обманывать: обманывают 
поиск: поиске 
работа: работы 
вызов: вызов 
скорый: скорой 
отдавать: отдашь 
зарплата: зарплату 
сша: сша 
почему: почему 
заводить: заводим 
ребенок: детей 
часто: чаще 
смеяться: смеемся 
ситуация: ситуацией 
плач: плачем 
банк: банк банки 
полиция: полиция 
противостоять: противостоят 
мошенник: мошенникам 
выбирать: выбрать 
страна: страну 
составлять: составляем 
осознанный: осознанный 
топ: топ 
направление: направлений 
работать: работает 
либидо: либидо 
делать: делать 
потеря: потере 
резидентство: резидентства 
детский: детский 
сад: сад 
быть: будете 
покупать: покупать 
покупка: покупках 
интернет: интернете 
спорт: спорт 
который: который которые которого 
тошнить: тошнить 
точно: точно 
продюсер: продюсер 
молодой: молодых 
музыкант: музыкантов 
иммунитет: иммунитет 
ты: тобой 
потрясать: потрясли 
бюджет: бюджеты 
признание: признания 
самый: самых 
непростой: непростых 
секретный: секретный 
токен: токен 
криптовалюта: криптовалютой 
заболеть: заболели 
граница: границей 
вакансия: вакансии 
сообщать: сообщить 
проблема: проблеме 
проект: проекте 
контакт: контакты 
политика: политика 
конфиденциальность: конфиденциальности 
правило: правила 
пользование: пользования 
сайт: сайтом 
ао: ао 
лицензия: лицензия 
