enel: enel 
закрывать: закрыл 
сделка: сделку сделке сделки 
продажа: продаже 
доля: доли долей 
россия: россия россии 
мобильный: мобильная 
версия: версия 
финмаркет: финмаркет 
туризм: туризм 
недвижимость: недвижимость 
событие: события 
образование: образование 
usd: usd 
eur: eur 
интерфакс: интерфакса интерфакс 
вход: вход 
подписчик: подписчиков 
главное: главное 
мир: мире 
экономика: экономика 
спорт: спорт 
культура: культура 
москва: москве москва 
digital: digital 
новость: новости новостях новостей 
сюжет: сюжеты 
фото: фото 
подписка: подписку подписка 
поиск: поиск 
хроника: хроника 
военный: военная 
операция: операция 
украина: украине 
обновлять: обновлено 
октябрь: октября 
обновление: обновление 
итальянский: итальянский итальянской итальянская 
продавать: продаст 
актив: активы 
млрд: млрд 
евро: евро 
сокращение: сокращения 
долг: долга 
энергохолдинг: энергохолдинг 
пао: пао 
говориться: говорится 
сообщение: сообщении 
компания: компании компаниях компания 
сайт: сайте сайта 
биржа: биржи 
владеть: владевший 
объявлять: объявил 
сумма: сумму 
млн: млн 
начало: начале 
июнь: июня 
последний: последний 
день: день 
сентябрь: сентября 
указ: указом 
президент: президента 
рф: рф 
покупатель: покупатели 
ао: ао 
управление: управление 
капитал: капиталом капитале 
действующий: действующее 
качество: качестве 
доверительный: доверительного 
управляющий: управляющего 
фонд: фондом 
получать: получит получил получать получили 
разрешение: разрешения разрешение 
покупка: покупку 
результат: результате 
акция: акций 
состав: состав 
входить: входят 
газовый: газовые 
электростанция: электростанции 
конаковский: конаковская 
грэс: грэс 
невинномысский: невинномысская 
среднеуральский: среднеуральская 
также: также 
ветропарк: ветропарк 
ростовский: ростовской 
область: области 
кроме: кроме 
строить: строит 
мурманский: мурманской 
энел: энел 
купить: купить 
профессиональный: профессиональную 
лента: ленту 
подписываться: подписаться 
рассылка: рассылку 
главный: главных 
оперативный: оперативные 
официальный: официальном 
канал: канале 
var: var 
bancont: bancont 
контейнер: контейнеру контейнера контейнер 
который: который 
добавлять: добавлен 
баннер: баннеры баннер баннеров 
randname: randname 
случайный: случайное 
число: число
установка: установка 
новое: нового 
id: id 
null: null 
settimeout: settimeout 
ownerid: ownerid 
containerid: containerid 
новый: новый 
params: params 
p: p 
puid: puid 
onstub: onstub 
function: function 
tabletwidth: tabletwidth 
phonewidth: phonewidth 
isautoreloads: isautoreloads 
false: false 
исключение: исключения 
показ: показа 
некорректный: некорректных 
задвоенный: задвоенным 
таймаут: таймаутом 
сечь: сек 
проверяться: проверяется 
задвоение: задвоение 
скрываться: скрывается 
вызываться: вызывается 
следующий: следующий 
инфинит: инфинит 
скролл: скролле 
присвоение: присвоение 
аттрибут: аттрибута 
первый: первого первой 
второй: второго 
onrender: onrender 
currentmainblock: currentmainblock 
февраль: февраля 
путин: путин 
разрешать: разрешил 
вк: вк 
приобретать: приобрести 
цена: цена 
апрельский: апрельских 
фьючерс: фьючерсов 
золото: золото 
падать: падала 
минимум: минимума 
начинать: начала 
год: год лет года 
доллар: доллар 
подешеветь: подешевел 
копейка: копейки копеек 
банк: банк 
отмечать: отметил 
продолжение: продолжение 
усиление: усиления 
ценовой: ценового 
давление: давления 
росстат: росстат 
перенести: перенес 
публикация: публикацию 
оценка: оценки оценку 
динамика: динамики 
ввп: ввп 
индекс: индексы 
мосбиржа: мосбиржи 
ртс: ртс 
вырастать: выросли 
предел: пределах 
налоговый: налоговых 
ненефтяной: ненефтяной 
экспорт: экспорт 
сингапур: сингапура 
январь: январе 
рухнуть: рухнул 
цб: цб 
хотеть: хочет 
вводить: ввести 
надбавка: надбавки 
коэффициент: коэффициентам 
риск: риска 
кредит: кредитам 
первичный: первичное 
жилье: жилье 
бывший: бывший 
владелец: владелец 
банка: банка 
колония: колонии 
плахотнюк: плахотнюка 
собянин: собянин 
оценивать: оценил 
локализация: локализацию 
производство: производства 
трамвай: трамваев 
читать: читают 
послание: послании 
федеральный: федеральному 
собрание: собранию 
давать: даст 
сво: сво 
международный: международной 
ситуация: ситуации 
тыс: тыс 
человек: людях человек 
заболеть: заболели 
коронавирус: коронавирусом 
сутки: сутки 
минобороны: минобороны 
заявлять: заявили 
подготовка: подготовке 
киев: киевом 
провокация: провокации 
радиоактивный: радиоактивными 
вещество: веществами 
контакт: контакты 
вакансия: вакансии 
реклама: реклама 
copyright: copyright 
interfax: interfax 
право: права 
защищать: защищены 
весь: вся 
информация: информация информации 
размещать: размещенная 
данный: данном 
предназначать: предназначена 
персональный: персонального 
пользование: пользования 
подлежать: подлежит 
дальнейший: дальнейшему 
воспроизведение: воспроизведению 
распространение: распространению 
форма: форме 
иначе: иначе 
письменный: письменного 
продукт: продукты 
информационный: информационной 
группа: группы 
товар: товарах 
спарк: спарк 
скаут: скаут 
маркер: маркер 
астра: астра 
рынок: рынки 
скан: скан 
ru: ru 
data: data 
центр: центр 
раскрытие: раскрытия 
корпоративный: корпоративной 
обнаруживать: обнаружили 
ошибка: ошибку ошибкой 
выделять: выделите 
фрагмент: фрагмент 
текст: текста 
нажимать: нажмите 
ctrl: ctrl 
enter: enter 
условие: условия 
использование: использования 
дизайн: дизайн 
