путешествие: путешествиях путешествии путешествий путешествия 
учебник: учебник 
сравнятор: сравнятор 
сообщество: сообщество 
ипотека: ипотека 
кредитный: кредитная 
история: историй история истории 
тест: тесты 
дневник: дневники дневник 
трата: траты трат 
налоговый: налоговый 
вычет: вычет 
написать: написать 
инвестиция: инвестиции 
бизнес: бизнес 
разбор: разборы 
закон: законов 
калькулятор: калькуляторы 
медицина: медицина 
здоровье: здоровье 
недвижимость: недвижимость 
подкаста: подкасты 
видео: видео 
смотреть: смотреть 
сервис: сервисы 
расчет: расчеты 
закладка: закладки 
письмо: письма 
оставаться: оставайтесь 
деньги: деньгами деньги 
поток: потоки 
нужно: нужно 
знать: знать 
путешественник: путешественникам путешественников 
год: год лет году 
отдыхать: отдохнуть отдыхать 
граница: границей 
спланировать: спланировать 
восхитительный: восхитительный 
отпуск: отпуск 
россия: россии 
сэкономить: сэкономить 
давать: дать 
обманывать: обмануть 
становиться: стать стал 
автор: автором 
герой: героем 
даниела: даниела 
антончук: антончук 
дискуссия: дискуссии 
рассказывать: расскажите 
какой: какие 
проблема: проблемы проблеме 
багаж: багажом 
возникать: возникали 
поездка: поездках 
редакция: редакция 
мнение: мнения мнение 
другой: другие 
страна: страны 
быстро: быстро 
менять: меняют 
мировоззрение: мировоззрение 
мария: мария 
рудницкая: рудницкая 
читатель: читатели 
эмигрировать: эмигрируют 
переезжать: переехать переехал 
риелтор: риелтором 
продавать: продал 
млн: млн 
доллар: долларов 
почитать: почитать 
мир: миру 
право: права 
безопасность: безопасность 
путешествовать: путешествовал путешествуют 
галина: галина 
назаров: назарова 
полтора: полторы 
комната: комнаты 
бродский: бродского 
зощенко: зощенко 
литературный: литературных 
музей: музеев 
петербург: петербурга 
юлия: юлия 
скопич: скопич 
ребенок: детьми дети 
коляска: колясок 
который: которые 
взять: взять 
ручной: ручной ручную 
кладь: кладь 
сергей: сергей 
драгун: драгун 
хороший: лучших 
пляж: пляжей 
таиланд: таиланда 
ольга: ольга 
чемоданова: чемоданова 
бэбиситтинг: бэбиситтинг 
очередь: очереди 
истерика: истерика 
самолет: самолете 
ирина: ирина 
половодова: половодова 
судебный: судебных судебные 
испортить: испортили 
ноутбук: ноутбук 
заставлять: заставили 
стоять: стоять 
перелет: перелетах 
поехать: поеду поехать 
март: марте 
александра: александра 
меньшиков: меньшикова 
новость: новости 
правило: правила 
въезд: въезда 
сербия: сербию 
россиянин: россиян 
anastasia: anastasia 
съездить: съездила 
непал: непал 
пожить: пожила 
буддийский: буддийском 
монастырь: монастыре 
doo: doo 
uap: uap 
покупка: покупки 
несколько: несколько 
тратить: тратила 
классный: классные 
впечатление: впечатления 
отстаивать: отстаивали 
свой: свои 
яна: яна 
рубин: рубина 
эмиграция: эмиграция 
легально: легально 
португалия: португалию 
анастасия: анастасия 
корнилов: корнилова 
делать: делать 
писать: пишут 
упрощать: упростила 
требование: требования 
класть: клади 
это: это 
правда: правда 
ярослав: ярослав 
гафнер: гафнер 
обман: обман 
турист: туристов 
запрет: запрет 
фото: фото 
разочаровывать: разочаровал 
египет: египет 
сингапур: сингапур 
отменять: отменит 
большинство: большинство 
коронавирусный: коронавирусных 
ограничение: ограничений 
екатерина: екатерина 
красоткин: красоткина 
образование: образование 
голова: голове 
каша: каша 
адаптироваться: адаптируются 
учеба: учебе 
скандал: скандалы 
мвд: мвд 
неразбериха: неразбериха 
госуслуга: госуслугах 
оформление: оформлении 
загранпаспорт: загранпаспортов 
пассер: пассер 
искать: искать 
работа: работу 
сайт: сайта сайтом 
вакансия: вакансиями вакансии 
ирена: ирена 
змигродский: змигродская 
кататься: кататься 
конек: коньках 
москва: москве москву 
каток: катков 
столица: столицы 
дарья: дарья 
стрельцов: стрельцова 
нога: ногой 
дорого: дорого 
грязно: грязно 
нечего: нечем 
заниматься: заняться 
почему: почему 
узбекистан: узбекистан 
e: e 
технический: технический 
специалист: специалист 
казань: казань 
получать: получили 
виза: визу 
цифровой: цифрового 
кочевник: кочевника 
собираться: собираетесь 
подавать: подавать 
документ: документы 
сообщать: сообщить 
проект: проекте 
контакт: контакты 
политика: политика 
конфиденциальность: конфиденциальности 
пользование: пользования 
выходить: выйти 
ао: ао 
банк: банк 
лицензия: лицензия 
