это: это 
компания: компаний компании компаниям компанию компания 
обзор: обзор 
бизнес: бизнес бизнеса 
стоять: стоят стоит 
покупать: покупать покупают 
облигация: облигация облигаций облигациям облигации 
промой: промо 
увеличивать: увеличила увеличьте увеличить 
доход: доходов доходы доход 
сообщество: сообществом сообщество 
инвестор: инвесторы инвесторов 
работать: работает 
учебник: учебник 
сравнятор: сравнятор 
ипотека: ипотека 
кредитный: кредитные кредитная кредитным кредитный кредитного 
история: история 
тест: тесты 
дневник: дневники дневник 
трата: трат 
налоговый: налоговые налоговую налоговый 
вычет: вычет вычета 
написать: написать 
инвестиция: инвестиции инвестициях инвестициями 
разбор: разборы 
закон: законов 
калькулятор: калькуляторы 
путешествие: путешествия 
медицина: медицина 
здоровье: здоровье 
недвижимость: недвижимость 
подкаста: подкасты 
видео: видео 
смотреть: смотреть смотрите 
сервис: сервис сервисы 
расчет: расчеты 
закладка: закладки 
письмо: письма 
оставаться: оставайтесь 
деньги: деньгами деньги денег 
поток: поток потоки 
инвестразбор: инвестразборы 
медицинский: медицинские медицинского 
стартап: стартапа 
какой: какую какие 
получать: получите получить получать получила получили получают 
доходность: доходности доходность 
тинькофф: тинькофф 
bonds: bonds 
rub: rub 
tbru: tbru 
р: р 
купить: купить 
первый: первая 
фонд: фонд 
корпоративный: корпоративные 
sbrb: sbrb 
вим: вим 
oblg: oblg 
атон: атон 
российский: российские российский российских российском российского 
amrb: amrb 
партнерство: партнерстве 
котировка: котировками котировки 
обновляться: обновляются 
минута: минут 
небольшой: небольшой 
производитель: производитель 
устройство: устройствами устройств устройства 
очищение: очищению очищения 
кровь: крови 
руководство: руководства руководство 
рассчитывать: рассчитывает 
рост: росте роста рост 
поэтому: поэтому 
ноябрь: ноября ноябре 
год: год лет году года 
привлекать: привлеченные привлекла 
облигационный: облигационному облигационный 
долг: долг долги долгу долга 
платить: платил платит 
купон: купона купон купоном купонов купонам 
привлекательность: привлекательности привлекательность 
низкий: низкая низкой низкие 
ликвидность: ликвидность ликвидности 
текущий: текущая текущий текущих текущую 
цена: цену ценах цене цена 
мочь: могут 
приносить: принести 
годовой: годовых 
рассказывать: расскажу расскажите 
заключаться: заключается 
высокий: высокую высокая высокие высоким 
сергей: сергей 
стаценко: стаценко 
торговать: торгует 
биржа: бирже 
заниматься: занимается 
финансовый: финансовые финансовых финансовое финансовым 
анализ: анализом 
профиль: профиль 
автор: автора 
параметр: параметры 
выпуск: выпуски выпуска 
номинал: номинал номинала 
рубль: рублей 
оферта: оферте оферты 
c: c 
учет: учетом учета 
налог: налоги налог налогов 
комиссия: комиссии 
погашение: погашения погашение погашению 
выплата: выплату выплата 
раз: раза 
ставка: ставке ставка ставки 
изменяться: изменится 
эмитент: эмитентов эмитент эмитента 
принудительно: принудительно 
выкупать: выкупить выкупят 
случай: случаях случае 
отмена: отмены 
досрочно: досрочно 
погасить: погасит погасят погасить 
остальной: остальные 
конец: конца конец концу конце 
срок: срок срока 
обращение: обращения 
подтверждать: подтвержденный 
октябрь: октябре 
рейтинг: рейтинги рейтингом рейтинг 
агентство: агентства 
ра: ра 
уровень: уровне уровень 
rubb: rubb 
статус: статусом 
наблюдение: наблюдением 
согласно: согласно 
исследование: исследованиям исследованию исследования 
рейтинговый: рейтингового 
подобный: подобным 
допускать: допустят 
дефолт: дефолт 
горизонт: горизонте 
три: трех 
зарабатывать: зарабатывает зарабатывают 
производить: производит 
одноразовый: одноразовые 
кроме: кроме 
прочий: прочего 
использовать: используйте используют 
терапия: терапии 
инфекция: инфекций 
коронавирус: коронавируса 
нужный: нужны 
отчасти: отчасти 
проводить: проводить 
клинический: клинические клиническое клинического 
который: который которые которого 
позволять: позволяют позволят 
находить: находить 
новый: новые новую новых 
область: области 
применение: применения 
лечение: лечения 
болезнь: болезней 
больший: большая 
часть: часть 
продажа: продажи продаж продажу 
приходиться: приходится придется 
москва: москве москву 
округ: округ 
раскрывать: раскрывает 
доля: доля доли долей 
импортный: импортную 
выручка: выручки выручка выручку 
дистрибьютор: дистрибьюторы дистрибьюторов 
казахстан: казахстане 
колумбия: колумбии 
турция: турции 
росздравнадзор: росздравнадзор 
разрешать: разрешил 
продукция: продукция продукцию продукции 
использование: использования использование 
основное: основном 
государственный: государственные 
учреждение: учреждения 
среднее: среднем 
тысяча: тысяч 
штука: штуку 
проблема: проблемы проблема проблеме 
входить: входят 
обязательный: обязательные 
протокол: протоколы 
спрос: спрос 
зависеть: зависит 
конкретный: конкретных 
решение: решений 
персонал: персонала 
собственный: собственным собственного собственному 
оценка: оценкам 
занимать: занимать занимает 
рынок: рынок рынки рынках рынке рынка 
успешно: успешно 
конкурировать: конкурируя 
американский: американскими 
японский: японскими японского 
другой: других другими другим 
иностранный: иностранными иностранным 
хотя: хотя 
судя: судя 
выделяться: выделяется 
фон: фоне 
конкурент: конкурентов конкуренты 
результат: результаты 
аналог: аналога 
toraymyxin: toraymyxin 
гораздо: гораздо 
возникать: возникали возникнут возникнуть 
трудность: трудности 
распространение: распространением 
международный: международных 
западный: западные 
страна: стран странах 
вводить: ввели 
санкция: санкции 
отношение: отношении отношение 
россия: россии 
закрывать: закрыты 
экспорт: экспорта 
делать: делать 
хороший: лучшие лучшее хорошие 
неделя: неделю 
ваш: вашей 
почта: почте 
каждый: каждый 
понедельник: понедельник 
бесплатно: бесплатно 
подписываться: подписаться подписывайтесь 
создавать: создали 
пять: пять 
дорастать: доросла 
млн: млн 
чистый: чистой чистая чистый 
прибыль: прибыли прибыль 
наращивать: наращивает 
производство: производство производства 
выходить: выйти выходит 
показатель: показатели показателей 
расти: растут расти 
несколько: несколько 
прогноз: прогноз прогнозы 
говорить: говорят 
тенденция: тенденции 
быстрый: быстрого 
продолжаться: продолжатся 
планировать: планируют планирует планировали 
выручать: выручить 
несмотря: несмотря 
идти: идут 
большой: большую большой 
маржинальность: маржинальность 
себестоимость: себестоимости 
изменение: изменению изменение 
налогообложение: налогообложения 
рентабельность: рентабельность 
источник: источник 
данные: данные 
отчетность: отчетность отчетности 
август: августе 
необходимо: необходимо 
лизинг: лизинг 
чужой: чужой 
возможно: возможно 
либо: либо 
сумма: суммы сумму 
полностью: полностью 
расход: расходы 
процент: процентов проценты 
заем: займу 
последующий: последующие 
месяц: месяцев 
составлять: составят составляет составить 
ebit: ebit 
снижаться: снизятся снизиться 
февраль: февраля 
поздно: позднее 
около: около 
привлечение: привлечения 
заимствование: заимствований 
все: всему 
капитальный: капитальные капитальных 
затрата: затраты затрат 
пока: пока 
планироваться: планируется 
размещать: размещенных 
прошлое: прошлого 
капитал: капитала капиталу 
актив: активах активов 
норма: норме 
значение: значении 
аналогичный: аналогичным 
вид: видом вид 
деятельность: деятельности 
развитый: развитых 
экономика: экономиках 
операционный: операционный 
денежный: денежный 
обслуживание: обслуживание 
презентация: презентация 
стр: стр 
аргумент: аргументы 
запускать: запустили 
производственный: производственную производственные 
линия: линию 
квартал: квартале 
мощность: мощности 
изделие: изделий 
эффект: эффект 
расширение: расширение расширения 
постепенно: постепенно 
отражаться: отражаться отражается 
благодаря: благодаря 
постепенный: постепенной 
отладка: отладке 
налаживание: налаживанию 
дистрибуция: дистрибуции 
выход: выход 
запуск: запуск 
продукт: продуктов продукт 
апрель: апреле 
зарегистрировать: зарегистрировала 
свой: свои 
цель: целям 
далеко: дальше 
расширяться: расширяться 
снг: снг 
июль: июле 
разрешение: разрешение 
колонка: колонки 
сбор: сбору 
ребенок: детей дети 
смочь: смогут 
закупать: закупать 
оба: оба 
событие: события 
помогать: помогут 
против: против 
спред: спреды 
средний: средний 
дневной: дневной 
оборот: оборот 
примерно: примерно 
спрэд: спрэд 
покупка: покупку 
достигать: достигать 
попробовать: попробуете 
приобретать: приобрести приобретали 
помощь: помощью 
кнопка: кнопки 
вместо: вместо 
приемлемый: приемлемой 
сила: силы 
нужно: нужно 
выставлять: выставить 
заявка: заявками заявку 
знакомый: знакомы 
лимитный: лимитными лимитные 
прочитывать: прочитайте 
наш: нашем наше 
барьер: барьеры 
вход: входа 
аналитик: аналитики 
считать: считаю считают 
очистка: очистки 
требоваться: требуются 
существенный: существенные 
плохо: плохо 
захотеть: захотят захотите 
выводить: вывести 
необходимый: необходимы 
долговременный: долговременные 
сильный: сильная 
концентрация: концентрация 
сконцентрировать: сконцентрировано 
два: двух 
площадка: площадках 
непредвиденный: непредвиденных 
обстоятельство: обстоятельств 
отсутствие: отсутствие 
диверсифицировать: диверсифицированного 
продуктовый: продуктового 
портфель: портфеля 
останавливать: остановить 
работа: работу 
итог: итоге 
прибыльный: прибыльный 
заканчивать: закончил 
будущее: будущем 
мир: мир 
нападать: нападет 
очередной: очередная 
стая: стая 
черный: черных 
лебедь: лебедей 
многие: многие 
достоинство: достоинству 
оценивать: оценили 
итоговый: итоговая 
упасть: упала упасть упадет 
справедливый: справедливый 
давать: дают 
ожидание: ожидания 
снижение: снижения снижение 
ключевой: ключевой 
стоимость: стоимость стоимости 
бумага: бумаги бумаг 
продолжать: продолжить 
прицел: прицелом 
скоро: скорее 
зафиксировать: зафиксируют 
последний: последнего 
период: периода 
понижать: понизят 
начисляться: начисляться 
долгосрочный: долгосрочные 
быть: будут 
держать: держать 
объем: объемы 
мониторять: мониторить 
участник: участников 
процентный: процентной 
состояние: состояние 
ожидаться: ожидается 
обратный: обратном 
падать: падать 
также: также 
становиться: станут 
продавать: продать 
ценный: ценные 
происходить: происходящего происходит 
биржевой: биржевом 
стакан: стакане 
ордер: ордера 
адекватный: адекватную 
помнить: помните 
один: одним 
отличие: отличие 
фармкомпания: фармкомпаний 
широкий: широким 
ассортимент: ассортиментом 
сложность: сложности 
реализация: реализацией 
повышаться: повысится 
вероятность: вероятность 
банкротство: банкротства 
высокодоходный: высокодоходного 
сектор: сектора 
должный: должны 
инвестиционный: инвестиционного 
рискованный: рискованных 
новость: новости 
касаться: касаются 
курс: курсе 
тэг: тэги 
эфферон: эфферон 
фотография: фотография 
обложка: обложке 
efferon: efferon 
jsc: jsc 
комментарий: комментарии 
проходить: проходят 
модерация: модерацию 
правило: правилам правила 
журнал: журнала 
shodan: shodan 
начинать: начала 
добавлять: добавили 
отвечать: ответить 
мошенник: мошенникам 
понадобиться: понадобились 
справка: справки 
репетитор: репетитор 
полагаться: полагался 
каникулы: каникулы 
человек: человеку человек 
инвалидность: инвалидностью 
копить: копить 
балл: баллы 
уведомлять: уведомлять 
счет: счет счетах 
белоруссия: белоруссии 
работник: работник 
поставлять: поставлять поставить 
товар: товары 
работодатель: работодателю 
ипать: ип 
молодой: молодой 
хотеть: хочет 
оформлять: оформить 
машина: машину 
риск: риски 
сотрудничать: сотрудничают 
сосед: соседи 
заливать: залили 
дверной: дверную 
ручка: ручку 
замок: замок 
клей: клеем 
протест: протест 
ремонт: ремонта 
завещание: завещание 
муж: мужа 
имущество: имущество 
здание: здание 
баланс: баланс 
багаж: багажом 
поездка: поездках 
косметичка: косметичка 
уход: уход 
чувствительный: чувствительной 
комбинированный: комбинированной 
кожа: кожей 
акна: акне 
последствие: последствия 
покупатель: покупателя 
продавец: продавец 
вносить: внесет 
сколько: сколько 
вернуть: вернуть 
обучение: обучение 
отрабатывать: отработала 
целевой: целевому 
договор: договор договору 
популярный: популярное 
посылка: посылка 
застревать: застряла 
таможня: таможне 
стаут: стауты 
гоза: гозе 
ламбик: ламбики 
место: мест 
пить: пить 
крафтовый: крафтовое 
пиво: пиво 
жить: живет 
бали: бали 
зарплата: зарплатой 
въезд: въезда 
сербия: сербию 
россиянин: россиян 
мнение: мнение 
поколение: поколение 
девяностый: девяностых 
лишний: лишнее 
труд: труда 
беспроводный: беспроводные 
удачный: удачных 
модель: моделей 
директор: директор 
розничный: розничной 
сеть: сети 
поволжье: поволжье 
экономист: экономист 
дежурный: дежурный 
электромонтер: электромонтер 
новосибирск: новосибирске 
тратить: тратила 
классный: классные 
впечатление: впечатления 
apple: apple 
watch: watch 
вакансия: вакансии 
сообщать: сообщить 
проект: проекте 
контакт: контакты 
политика: политика 
конфиденциальность: конфиденциальности 
пользование: пользования 
сайт: сайтом 
ао: ао 
банк: банк 
лицензия: лицензия 
