хороший: лучшие хорошая хороший лучших хорошим хорошие хорошее лучший лучшее 
пивной: пивной пивные пивных 
ресторан: рестораны ресторанов 
паб: пабы паб паба пабе 
москва: москве москву москвы 
пить: пил пить 
крафтовый: крафтовом крафтовых крафтовый крафтовое 
пиво: пиву пивом пиве пива пиво 
промой: промо 
бесплатный: бесплатная бесплатных 
кредитка: кредитка 
промокод: промокоду 
fgo: fgo 
давать: даешь давайте 
учебник: учебник 
сравнятор: сравнятор 
сообщество: сообщество 
ипотека: ипотека 
кредитный: кредитная 
история: история 
тест: тесты 
дневник: дневники дневник 
трата: трат 
налоговый: налоговые налоговую налоговый 
вычет: вычет 
написать: написать 
инвестиция: инвестиции 
бизнес: бизнес бизнеса 
разбор: разборы 
закон: законов 
калькулятор: калькуляторы 
путешествие: путешествия 
медицина: медицина 
здоровье: здоровье 
недвижимость: недвижимость 
подкаста: подкасты 
видео: видео 
смотреть: смотреть 
сервис: сервисы 
расчет: расчеты 
закладка: закладки 
письмо: письма 
оставаться: остался оставайтесь 
деньги: деньгами деньги денег 
поток: потоки 
стаут: стауты стаут стаута стаутов стаутом 
гоза: гозе 
ламбик: ламбика ламбики 
место: места месте мест местах местом место 
лера: лера 
варпаева: варпаева 
немного: немного 
пьяный: пьяна 
профиль: профиле профиль 
автор: автора автор 
начало: начале 
россия: россии 
происходить: произошла 
крафтовой: крафтовыми крафтовая крафтового 
революция: революция 
который: который которые которых которого которую которая котором 
доказывать: доказала 
разный: разных разным разное разными 
сладкий: сладким 
кислый: кислым 
острый: острым 
вслед: вслед 
это: этому это этим 
появляться: появляется появились появляются появилась 
независимый: независимые 
пивоварня: пивоварен пивоварни 
варить: варят 
необычный: необычной необычное необычная 
бар: бары бар бара баре баров 
попробовать: попробовать 
собирать: собирать собрала 
вкусный: вкусное вкусной вкусным вкусными 
российский: российского российских российское российскую 
зарубежный: зарубежного зарубежных 
отмечать: отмечены отметили 
карта: карте карту 
сохранять: сохраните сохранили 
статья: статья статьи статье статью 
быстро: быстро 
находить: найти нашли 
нужный: нужный нужному нужна 
собираться: соберетесь 
редакция: редакции 
вредно: вредно 
год: годов лет году 
причина: причин 
связанный: связанных 
алкоголь: алкоголем алкоголя алкоголь 
умирать: умерли 
тысяча: тысяч 
человек: людей человеку людям человек 
этот: эта 
пропагандировать: пропагандирует 
употребление: употребление 
рассказывать: рассказывает расскажите 
интересный: интересного интереснее интересных интересным интересные 
весело: весело 
проводить: провести проводят 
время: времена время времени временем 
один: одно одном одной 
упоминать: упомянутых 
заведение: заведения заведениях заведение заведений 
мы: нами нам 
платить: платило платил 
проставляться: проставлялось 
отдыхать: отдыхайте 
быть: будут будьте 
здоровый: здоровы 
ваш: ваш 
спица: спица 
кратко: кратко 
красивый: красивых красивую красивым красивый 
балкон: балкон балконом 
отличный: отличное отличной 
пицца: пиццей пицца пиццу 
адрес: адрес 
никольская: никольская 
подробно: подробнее 
находиться: найдется находится найдутся 
тц: тц 
лубянка: лубянку лубянке 
самый: самые самое самом самый самых 
китчевый: китчевых 
здание: зданий здании здание 
эпоха: эпохи 
лужковский: лужковской 
застройка: застройки 
кран: крану кранах кранов крана 
вариант: вариантов 
крафт: крафте крафта крафтом крафт 
большой: большим большой 
выбор: выбором выбору выбор 
бутылочный: бутылочного 
вкусно: вкусно 
основательно: основательно 
поесть: поесть 
открытый: открытой 
кухня: кухня кухне кухни 
готовить: готовит готовят 
правильный: правильный правильном 
тонкий: тонком 
итальянский: итальянском 
тесто: тесте 
баклажан: баклажанами 
перец: перцем 
салями: салями 
простой: простую 
также: также 
меню: меню 
салат: салаты салат 
сэндвич: сэндвичи сэндвич 
начинка: начинками 
сидячий: сидячие сидячих сидячем 
зато: зато 
вид: вида видов видом видами 
лето: летом 
превращаться: превращается 
веранда: веранды веранда веранду верандой 
moon: moon 
tune: tune 
porter: porter 
р: р 
рукол: рукола 
mission: mission 
веган: вегану 
спартаковский: спартаковская 
стр: стр 
сайт: сайте сайтом 
старый: старую старом 
флигель: флигеле 
полностью: полностью 
веганский: веганское веганский веганская 
наливать: наливают наливаете 
кофе: кофе 
комбучивать: комбучу 
желатин: желатина 
лактоза: лактозы 
ехать: еду 
продукт: продуктов 
животное: животного 
происхождение: происхождения 
разрушать: разрушая 
стереотип: стереотип 
еда: еды едой еда 
скучный: скучная 
сочный: сочные 
бургер: бургеры бургерами бургер 
растительный: растительным 
мясо: мясо мясом 
карри: карри 
наггетс: наггетсы 
десерт: десерты 
яйцо: яиц 
молоко: молока 
рад: рады 
посетитель: посетителям 
собака: собаками 
michelada: michelada 
кимчать: кимчи 
биртайм: биртайм 
брутальный: брутальный брутальным 
душа: душой 
новослободский: новослободская новослободской 
душевный: душевный 
переулок: переулках переулок 
демпинговый: демпинговыми 
цена: ценами цены 
бутылка: бутылок бутылках 
прилавок: прилавком 
классика: классику классика классике 
jaws: jaws 
af: af 
brew: brew 
закуска: закусками закусок закуски закуска 
короткий: короткое 
проверенный: проверенное 
гренок: гренки 
картошка: картошку картошка 
фри: фри 
сушка: сушки 
вечер: вечер вечерам 
выходной: выходным выходные выходных 
заканчиваться: заканчиваются 
вечеринка: вечеринка вечеринки 
плавно: плавно 
перетекать: перетекает 
ipa: ipa 
соня: соня 
прогресс: прогресс 
сеть: сети сетях сеть 
бармен: барменом бармены бармен барменами 
пресненский: пресненский 
вал: вал 
волоколамский: волоколамское 
шоссе: шоссе 
фрунзенский: фрунзенская 
набережная: набережная 
гиляровский: гиляровского 
любить: люблю любят 
болтать: болтать 
класть: кладете 
специальный: специальная специальную 
прикладывать: прикладываете 
самостоятельно: самостоятельно 
списываться: списываются 
миллилитр: миллилитры 
поэтому: поэтому 
несколько: несколько несколькими 
точка: точку точка точек точках 
каждый: каждой каждые каждый 
эффектный: эффектные 
советский: советские 
мозаика: мозаики 
пресня: пресне 
брать: берите 
котлета: котлеты котлету 
вьетнамский: вьетнамские 
фо: фо 
бо: бо 
нема: немы 
white: white 
твой: твои твое 
друг: друзьями друзья 
пионер: пионеры 
малый: малый 
гнездниковский: гнездниковский 
первый: первыми первая первом первых первую первого 
открываться: открывается открылся 
рано: раньше 
вход: вход 
сувенирный: сувенирную 
лавка: лавки лавку 
расширяться: расширился 
вдвое: вдвое 
захватить: захватил 
площадь: площадь 
работать: работает работают 
день: днем день 
шесть: шести 
утро: утра 
пятница: пятницу пятницам 
играть: играют 
снэк: снэки 
приторный: приторного 
сидр: сидра сидров сидр сидру 
редкий: редкое редкие 
позиция: позицию позиций позиции 
рубеж: рубежа 
отзывчивый: отзывчивые 
помогать: помогут 
сделать: сделать 
понимать: понимаете 
воскресение: воскресенье 
диджей: диджеи 
stamm: stamm 
apa: apa 
blanche: blanche 
de: de 
bruxelles: bruxelles 
rule: rule 
taproom: taproom 
пять: пяти 
минута: минутах 
кремль: кремля 
староваганьковский: староваганьковский 
центр: центре 
адекватный: адекватными 
среднее: среднем 
уважать: уважают 
zagovor: zagovor 
brewery: brewery 
новинка: новинками новинки новинок 
никто: никто 
против: против 
заказывать: закажете заказать 
другой: другие других 
sadwave: sadwave 
kriek: kriek 
boon: boon 
method: method 
стильный: стильный 
пространство: пространстве 
товарищеский: товарищеский 
обосновываться: обосновался 
бывший: бывшей 
керамический: керамической 
фабрика: фабрики фабриках 
основное: основном 
удобно: удобно 
следить: следить 
возможность: возможность 
порция: порции порциях 
мл: мл 
определяться: определиться 
предпочтение: предпочтениями 
подавать: подают 
говядина: говядины говядиной 
фиша: фиш 
тако: тако 
бриошь: бриошью 
предлагать: предложу предлагают 
блюдо: блюда блюдо 
вне: вне 
dry: dry 
nitro: nitro 
stout: stout 
вешенка: вешенкой 
чипотел: чипотле 
главпивмаг: главпивмаг 
боттлшоп: боттлшоп боттлшопа боттлшопом 
макаренко: макаренко 
пятницкий: пятницкий 
микросеть: микросеть 
вырастать: выросла 
сей: сих 
пора: пор 
территория: территории 
рынок: рынок рынке рынка 
специализироваться: специализируются 
микропивоварня: микропивоварнях микропивоварен 
публиковать: публикуют 
актуальный: актуальный 
список: список списку 
чистый: чистые чистых 
пруд: пруды прудах 
магазин: магазинов магазина магазин 
навынос: навынос 
стоять: стоя стоит 
дешево: дешевле 
незамысловатый: незамысловатая 
отдельный: отдельное 
удовольствие: удовольствие 
фирменный: фирменные 
бирдекель: бирдекели 
saldens: saldens 
tomato: tomato 
gose: gose 
прачечная: прачечная 
beermood: beermood 
посиделки: посиделок 
компания: компанией 
чистопрудный: чистопрудный 
бульвар: бульвар 
соседний: соседняя 
дверь: дверью дверей дверь 
c: c 
просторный: просторный 
летний: летней 
зал: залами 
спрятаться: спрятался 
кикер: кикер 
сорт: сорта сортов 
стойка: стойкой 
около: около 
эль: элей 
мир: мира 
сюда: сюда 
страшно: страшно 
приходить: прийти приходить 
голодный: голодным 
неожиданный: неожиданные 
ризотто: ризотто 
четыре: четырьмя 
сыр: сыра 
брускетт: брускетты 
тартар: тартар 
стол: стол 
бронировать: бронировать 
заранее: заранее 
арбузный: арбузному арбузный 
мортаделла: мортаделлой 
птица: птица 
синица: синица 
чердак: чердака чердаке 
спасоглинищевский: спасоглинищевский 
придумывать: придумывая 
интерьер: интерьер интерьером 
владелец: владельца владельцы 
вдохновляться: вдохновлялись 
будапешт: будапешта 
слегка: слегка 
обшарпанный: обшарпанные 
стена: стены 
вещь: вещи 
превращать: превращенные 
распиливать: распиленные 
ванна: ванны 
вместо: вместо 
диван: диванов 
знаменитый: знаменитом 
szimpla: szimpla 
kert: kert 
alaska: alaska 
привозить: привозит привозят 
замысловатый: замысловатое 
базовый: базовую базовые 
пастрами: пастрами 
вишневый: вишневые вишневый 
крик: крик крики 
cream: cream 
corn: corn 
дом: домах дом 
посреди: посреди 
расти: растет 
дерево: дерево 
покровка: покровка 
неприметный: неприметной 
прятаться: прячется 
двухэтажный: двухэтажный 
называть: названный 
честь: честь 
роман: романа 
мариам: мариам 
петросян: петросян 
главный: главного 
зала: зала 
огромный: огромный огромную огромное 
уходящий: уходящее 
крыша: крышу 
вокруг: вокруг 
сундук: сундуки 
арка: арки 
книга: книг 
череп: черепа 
печатный: печатные 
машинка: машинки 
фотография: фотографии фотографию 
среди: среди 
основной: основные основная 
стиль: стиль стили 
ассортимент: ассортиментом ассортимент 
часто: часто 
обновлять: обновляют 
пока: поке 
форшмак: форшмак 
горячий: горячие 
атмосфера: атмосферы атмосфере 
очень: очень 
популярный: популярные популярное популярный 
броня: брони 
позаботиться: позаботиться 
nutty: nutty 
nut: nut 
полкило: полкило 
мидия: мидии мидий 
craft: craft 
republic: republic 
экспериментальный: экспериментальный экспериментальными экспериментальные 
сербский: сербская сербские 
тверской: тверской 
классический: классические классических классическим 
сложно: сложно 
например: например 
меломель: меломель 
медовуха: медовуху 
крепость: крепостью 
фрукт: фруктах 
ягода: ягодах 
одуванчик: одуванчиках 
бекон: беконом 
оливка: оливками 
маринованный: маринованными 
огурец: огурцами 
кинза: кинзой 
давно: давно 
хотеть: хотели хочет 
выпивать: выпью выпить выпивать 
плескавица: плескавицу 
чорба: чорбу 
шопский: шопский 
домкрат: домкрат 
чевапать: чевапи 
энтузиаст: энтузиаст 
мотокафе: мотокафе 
классный: классные классным 
мерч: мерчем 
столешников: столешников 
аккуратный: аккуратном 
дворик: дворике дворик двориком 
чинить: чинят 
велосипед: велосипеды 
крутить: крутят 
кино: кино 
продавать: продают 
винить: винил 
собственный: собственного 
магазинчик: магазинчика 
enthusiast: enthusiast 
records: records 
узнаваемый: узнаваемый 
дух: духе 
родченко: родченко 
лисицкий: лисицкого 
постер: постеры 
основатель: основатели основателя 
дмитрий: дмитрия дмитрий 
пантюшин: пантюшина 
футболка: футболки 
логотип: логотипом 
купить: купить 
небольшой: небольшой 
сбалансировать: сбалансированный 
отлично: отлично 
подходить: подходят 
панини: панини 
magners: magners 
parka: parka 
пятницкая: пятницкая 
свободный: свободный 
столик: столик 
амфитеатр: амфитеатре 
этаж: этаже этажа 
разливный: разливного 
включая: включая 
производитель: производителей 
сырный: сырные 
пончик: пончики 
кесадилья: кесадилью кесадильи 
соус: соусе 
duchesse: duchesse 
bourgogne: bourgogne 
share: share 
house: house 
особняк: особняки особняк особняка 
винил: винилом 
оружейный: оружейный 
занимать: занять занимает 
внутри: внутри 
кирпичный: кирпичную 
кладка: кладку 
сформировывать: сформировано 
лояльный: лояльное 
комьюнити: комьюнити 
биргик: биргиков 
двор: дворе двор 
симпатичный: симпатичная 
ставить: ставят 
untappd: untappd 
прилагаться: прилагается 
барный: барная 
шаурма: шаурма 
картофель: картофель 
мид: мид 
bochet: bochet 
dogma: dogma 
кладезь: кладезь 
редкость: редкостей 
маленький: маленьком маленький 
гордый: гордый 
солянка: солянки 
уголок: уголков 
земля: земли 
больший: большая 
часть: часть 
банк: банк банках 
очередь: очередь очереди 
заходить: заходить 
домашний: домашней 
дегустация: дегустации 
hot: hot 
wax: wax 
melata: melata 
ginja: ginja 
ba: ba 
borrachitos: borrachitos 
тверская: тверская 
мексиканский: мексиканский 
аутентичный: аутентичными 
щедрый: щедрые 
начос: начос 
название: название названием названия 
переводиться: переводится 
испанский: испанского 
осторожно: осторожнее 
местный: местными 
портер: портерами 
имперский: имперским 
меняться: меняется 
социальный: социальных 
финский: финский 
немецкий: немецкий 
американский: американский 
iggy: iggy 
hop: hop 
сет: сет 
три: трех 
подозрительный: подозрительные 
лицо: лица 
дружелюбный: дружелюбны дружелюбный 
уютный: уютный 
тихий: тихих тихий 
чугунный: чугунного 
мост: моста 
сам: сами 
локальный: локальных 
марка: марок 
planb: planb 
приглашать: приглашают 
музыкант: музыкантов 
адаптировать: адаптирована 
закусывать: закусывать 
чили: чили 
кон: кон 
карн: карне 
мальборо: мальборо 
beer: beer 
gik: gik 
интеллигентный: интеллигентный 
мясницкий: мясницкая 
светлый: светлый 
холодильник: холодильником холодильник 
фруктовый: фруктовые 
сауэр: сауэры 
дистиллят: дистилляты 
эксклюзив: эксклюзивы 
херес: херес 
портвейн: портвейн 
биодинамический: биодинамические 
вино: вино вина 
обновляться: обновляется 
напиток: напитки напитков 
бокал: бокалом бокалах бокалам 
панда: пандой 
символ: символом 
становиться: стать стали 
подача: подаче 
пекорино: пекорино 
трюфель: трюфелями трюфелем 
хамон: хамон 
гриссинить: гриссини 
sour: sour 
cherrynade: cherrynade 
выдающийся: выдающийся 
гриль: грилем гриль 
цветной: цветной 
нарочито: нарочито 
бородатый: бородатыми 
крылышко: крылышками 
понятно: понятно 
сотня: сотни 
дичь: дичь 
подборка: подборку подборка подборке 
противник: противников 
головной: головной 
боль: боли 
коктейль: коктейли 
заглядывать: заглянуть 
рюмочный: рюмочные 
отравляться: отравиться 
поддельный: поддельным 
подписываться: подписаться 
тэг: тэги 
какой: какие каком 
город: городе городу 
жить: живет живете 
комментарий: комментарии 
проходить: проходят 
модерация: модерацию 
правило: правилам правила 
журнал: журнала 
девка: девка 
руль: рулем 
герой: герой 
нужно: нужно 
зацензуривать: зацензурить 
чрезмерный: чрезмерную 
сексуальность: сексуальность 
отвечать: ответить 
андрей: андрей 
фиалкин: фиалкин 
пивотек: пивотека 
стыдно: стыдно 
такой: такие такого такое 
знать: знал знать 
филипп: филипп 
кругликов: кругликов 
алексей: алексей 
сидоров: сидоров 
удивляться: удивился 
пивотека: пивотеки 
screw: screw 
l: l 
добавлять: добавлю добавляю добавил 
половина: половину 
особенно: особенно 
активно: активно 
ходить: ходишь ходил 
новый: новые 
завлекательный: завлекательно 
описывать: описала 
velvetdust: velvetdust 
отредактировать: отредактировано 
sharehouse: sharehouse 
эрик: эрика 
рыжий: рыжего 
galaxy: galaxy 
брат: братья 
самовар: самовар 
панк: панк 
штука: штук 
crafter: crafter 
особо: особо 
народ: народа 
куча: куча 
varka: varka 
вроде: вроде 
нормально: нормально 
igor: igor 
danilov: danilov 
кайф: кайф 
vyacheslav: vyacheslav 
primha: primha 
владимир: владимире владимир 
яровой: яровой 
pivbar: pivbar 
сергей: сергей 
капличный: капличный 
марьина: марьиной 
роща: роще 
миниатюрный: миниатюрное 
будка: будка будку 
ребята: ребят ребята 
переделывать: переделали 
настоящий: настоящую 
трансформаторный: трансформаторную 
вадим: вадим 
панченко: панченко 
любимый: любимые любимое любимый 
квнщик: квнщиков 
oleg: oleg 
tsarev: tsarev 
включать: включили 
всякий: всякий всякие 
треш: треш 
руины: руин 
пропускать: пропускаете пропустили 
данный: данный 
момент: момент 
качество: качеству 
формат: формату 
антон: антон 
журавки: журавков 
полина: полина 
калмыков: калмыкова 
редактор: редактор 
пушкинский: пушкинской 
шумно: шумно 
легко: легко 
устраивать: устраивать устраивают 
миля: мили 
pub: pub 
калашный: калашном 
британский: британский 
ламповый: ламповые 
внутренний: внутреннем 
разъехаться: разъехались 
второй: втором второй 
сторона: стороны 
дома: дома 
выходить: выйти вышел выходить выходит 
гиннес: гиннес 
уютно: уютнее 
анна: анна 
гаврилов: гаврилова 
подтверждать: подтверждаю 
именно: именно 
спонсор: спонсор 
мой: моей 
сегодняшний: сегодняшней 
утренний: утренней 
вовенчегга: вовенчегг 
пискунов: пискунов 
игги: игги 
игорь: игорь 
кошкин: кошкин 
спасибо: спасибо 
записывать: записал 
пара: пару пара 
dmitry: dmitry 
stepanov: stepanov 
свао: свао 
окраина: окраин 
культ: культ 
еж: еж 
pivtown: pivtown 
близнец: близнецы 
alexander: alexander 
pletnev: pletnev 
замечание: замечаний 
догма: догмы 
полиция: полиции полиция 
патрулировать: патрулирует 
просто: просто 
условный: условный 
перекур: перекур 
отправляться: отправиться 
автозак: автозак 
проект: проекте проект 
заговор: заговора 
anastasia: anastasia 
bosio: bosio 
mood: mood 
ван: ван 
лава: лав 
путь: пути 
вести: ведут 
пшеничный: пшеничному 
жаль: жаль 
регулярный: регулярных 
облава: облав 
посидеть: посидишь 
снаружи: снаружи 
пиццой: пиццой 
душевно: душевно 
кстати: кстати 
приезжать: приезжаю 
ноутбук: ноутбуком 
поработать: поработать 
главное: главное 
стратегический: стратегическую 
подоконник: подоконнике 
вика: вика 
плотаненко: плотаненко 
мать: мать 
шорты: шортов 
вячеслав: вячеслав 
ерофеев: ерофеев 
дыра: дыра 
большинство: большинство большинства 
serge: serge 
g: g 
harbor: harbor 
кроме: кроме 
метро: метро 
арахис: арахиса 
бир: бир 
харбор: харборе 
обалденный: обалденная 
приличный: приличными 
gustaf: gustaf 
shnebel: shnebel 
bar: bar 
максим: максим 
коломиец: коломиец 
los: los 
banditos: banditos 
vолчья: vолчья 
стая: стае стая 
порядок: порядка 
иностранный: иностранным иностранный 
разлив: разлив 
достойный: достойных 
покушать: покушать 
джонни: джонни 
кэтсвилы: кэтсвил 
lucky: lucky 
seven: seven 
думать: думаю думаете 
открывать: открыть 
месяц: месяц 
слово: слова 
cathy: cathy 
мало: мало 
пойти: пойдет 
непонятный: непонятное 
рубль: рублей 
прогорать: прогорели 
ждать: жду ждала 
пивко: пивко 
axiom: axiom 
бауманок: бауманке 
закрытый: закрытый 
гирлянда: гирляндами 
наличие: наличии 
огуречный: огуречные 
прочий: прочая 
fcking: fcking 
новослободка: новослободке 
переживать: пережил 
карантин: карантин 
факинкрафт: факинкрафт 
переезжать: переедет 
анонс: анонсов 
дарья: дарья 
ристевский: ристевски 
капитан: капитан 
соцсеть: соцсетей 
илья: илья 
желнов: желнов 
bb: bb 
ларчик: ларчиков 
howard: howard 
loves: loves 
sever: sever 
drunk: drunk 
punk: punk 
viktoriia: viktoriia 
арма: арма арме 
догадываться: догадаться 
средний: средние среднего 
ниже: ниже 
artemiy: artemiy 
str: str 
kakadu: kakadu 
nikita: nikita 
belousov: belousov 
жалко: жалко 
какаду: какаду 
весь: весь 
шведский: шведский 
туоль: туоль 
пр: пр 
приседать: присесть 
правда: правда 
усачевский: усачевский 
фудкорт: фудкортом 
любой: любой 
вкус: вкус 
везде: везде 
пускать: пускают 
выбирать: выбираешь 
попивать: попивая 
mud: mud 
cake: cake 
омниполло: омниполло 
красота: красота 
nikolay: nikolay 
karpunin: karpunin 
зря: зря 
тьма: тьму 
сексуальный: сексуальных 
тематический: тематических 
пример: примеру 
незаурядный: незаурядным 
заморачиваться: заморочились 
палуба: палубе палуба 
корабль: корабля 
бесконечный: бесконечного 
количество: количества 
давний: давнего 
еще: ещё 
крепчаг: крепчага 
раскрутецкий: раскрутецкий 
прямо: прямо 
нога: ногами ногой 
галька: галька 
потолок: потолке 
олимп: олимп 
мохнатый: мохнатых 
восхитительный: восхитительны 
некоторые: некоторые 
схоронить: схоронил 
петербург: петербург 
шубарец: шубарцов 
продолжение: продолжения 
питер: питер 
бас: басов 
бродячий: бродячий 
суслик: суслик 
камерный: камерное 
бельгийский: бельгийскими 
вафля: вафлями 
никонов: никонов 
должно: должно 
туалет: туалет 
второстепенный: второстепенный 
вопрос: вопрос 
каракчеев: каракчеев 
странно: странно 
некий: некий 
некто: некто 
странный: странная 
все: всё 
многолетний: многолетние 
тип: типа 
бирмаркет: бирмаркет 
happens: happens 
раз: разы 
отсутствовать: отсутствуют 
боже: боже 
карл: карл 
вообще: вообще 
удивлять: удивляет 
полупомойка: полупомойка 
студент: студентов 
непонятно: непонятно 
анастасия: анастасия 
евгений: евгений 
ясно: ясно 
солнышко: солнышко 
два: две 
джанлука: джанлука 
неизвестный: неизвестный 
итальянец: итальянец 
сергеев: сергеев 
постоянно: постоянно 
рейд: рейды 
периметр: периметр 
привет: привет 
туда: туда 
чувство: чувство 
сговор: сговоре 
лернейский: лернейская 
гидра: гидра 
салденс: салденсе 
разбираться: разбирается 
писать: писали 
тема: теме 
терем: терема 
изба: избы 
отель: отелей 
гестхаус: гестхаусов 
старинный: старинных 
современный: современных современного 
музей: музеев 
галерея: галерей 
предел: пределами 
опьянеть: опьянеть 
московский: московских 
фантастический: фантастическим 
чебурек: чебуреки 
настойка: настойки 
старообрядческий: старообрядческие 
вареник: вареники 
легендарный: легендарные 
кафе: кафе 
поиграть: поиграть 
настолочь: настолки 
делать: делать делают 
мороженое: мороженое 
сырок: сырки 
шоколад: шоколад 
экскурсия: экскурсий 
видеоигр: видеоигр 
заменять: заменят 
игра: игры 
детство: детства 
искусство: искусства 
чай: чая 
сопровождение: сопровождение 
мастер: мастера 
сходить: сходить 
чайный: чайную 
церемония: церемонию 
чоризо: чоризо 
груша: грушей 
сало: салом 
суточный: суточные 
щи: щи 
русский: русской 
искать: искать 
посуда: посуду 
опальный: опальные 
классик: классики 
дерзкий: дерзкие 
миллениал: миллениалы 
мясной: мясные 
бургерный: бургерных 
мошенник: мошенникам 
понадобиться: понадобились 
справка: справки 
репетитор: репетитор 
полагаться: полагался 
каникулы: каникулы 
налог: налог налоги 
инвалидность: инвалидностью 
копить: копить 
покупать: покупать 
балл: баллы 
уведомлять: уведомлять 
счет: счет счетах 
белоруссия: белоруссии 
работник: работник 
поставлять: поставлять поставить 
товар: товары 
работодатель: работодателю 
ипать: ип 
молодой: молодой 
оформлять: оформить 
машина: машину 
риск: риски 
сотрудничать: сотрудничают 
сосед: соседи 
заливать: залили 
дверной: дверную 
ручка: ручку 
замок: замок 
клей: клеем 
протест: протест 
ремонт: ремонта 
завещание: завещание 
ребенок: дети детей 
муж: мужа 
получать: получать получили 
имущество: имущество 
стоимость: стоимости 
баланс: баланс 
проблема: проблемы проблеме 
багаж: багажом 
возникать: возникали 
поездка: поездках 
косметичка: косметичка 
уход: уход 
чувствительный: чувствительной 
комбинированный: комбинированной 
кожа: кожей 
акна: акне 
последствие: последствия 
покупатель: покупателя 
продавец: продавец 
вносить: внесет 
доля: доли 
сколько: сколько 
вернуть: вернуть 
обучение: обучение 
отрабатывать: отработала 
срок: срок 
целевой: целевому 
договор: договор договору 
составлять: составить 
процент: проценты 
неделя: неделю 
посылка: посылка 
застревать: застряла 
таможня: таможне 
бали: бали 
зарплата: зарплатой 
въезд: въезда 
сербия: сербию 
россиянин: россиян 
мнение: мнение 
поколение: поколение 
девяностый: девяностых 
лишний: лишнее 
труд: труда 
беспроводный: беспроводные 
колонка: колонки 
удачный: удачных 
модель: моделей 
директор: директор 
розничный: розничной 
поволжье: поволжье 
экономист: экономист 
дежурный: дежурный 
электромонтер: электромонтер 
новосибирск: новосибирске 
тратить: тратила 
впечатление: впечатления 
apple: apple 
watch: watch 
вакансия: вакансии 
сообщать: сообщить 
контакт: контакты 
политика: политика 
конфиденциальность: конфиденциальности 
пользование: пользования 
ао: ао 
лицензия: лицензия 
