жить: живу живет жила жил живут 
бали: бали 
зарплата: зарплатой зарплаты зарплата зарплате зарплату 
промой: промо 
кредитка: кредиткой кредитки 
день: дня дни день дней 
заказывать: заказывала заказывать заказанному заказываю заказываем заказать 
карта: картой карты карту 
учебник: учебник учебника 
сравнятор: сравнятор 
сообщество: сообщество 
ипотека: ипотеку ипотека 
кредитный: кредитная 
история: историю история истории 
тест: тестов тесты 
дневник: дневники дневник дневника дневнике 
трата: траты трат трата 
налоговый: налоговые налоговую налоговый 
вычет: вычет 
написать: написать написали написан написал 
инвестиция: инвестиции инвестициях 
бизнес: бизнес бизнеса 
разбор: разборы 
закон: закон законов 
калькулятор: калькуляторы 
путешествие: путешествий путешествия 
медицина: медицина 
здоровье: здоровье 
недвижимость: недвижимость 
подкаста: подкасты 
видео: видео 
смотреть: смотрели смотрю смотреть 
сервис: сервис сервисы сервисов 
расчет: расчеты 
закладка: закладки 
письмо: письма письму письмо 
оставаться: осталось остаются оставайтесь оставшуюся оставалось остается оставаться останется остаться осталась остался остались 
деньги: деньгами деньги денег 
поток: потоки 
середина: середине середины середину 
январь: январе января 
год: год году годам лет года 
little: little 
hippo: hippo 
зарабатывать: зарабатывает 
р: р 
профиль: профиль 
автор: автора автор 
возраст: возраст возрасте 
город: города городе город 
обычный: обычное обычной обычная обычный 
жизнь: жизнь жизни 
пригород: пригород пригороде 
зима: зиму 
проводить: проводим провожу провести проводят 
окрестности: окрестностях 
популярный: популярна популярное популярной популярен популярных популярным популярную 
туристический: туристической 
деревня: деревне деревни 
чанга: чангу 
семья: семья семьи семьей 
питер: питере питером 
общий: общую общему общий общая общей 
квартира: квартире квартиры квартиру 
мама: маме мамы мамой мама 
продавец: продавцами продавцов продавец 
магазин: магазину магазинах магазин магазине магазина 
месяц: месяца месяце месяц месяцев 
возвращение: возвращения возвращении 
планировать: планирую планировала 
переезжать: переехать переехали переехала 
ипотечный: ипотечную ипотечные 
студия: студии студию студия 
ремонт: ремонт ремонта 
который: который которой которые которых которую которая котором которое которым которому 
заканчиваться: заканчивается закончилось закончился закончилась 
несколько: несколько нескольким 
неделя: недели неделе неделю неделей недель 
мой: моем мою моих мое моего мои моим моей 
отъезд: отъезд отъезде отъездом отъезда 
нежно: нежно 
любимый: любимые любимого любимое любимом любимый любимую 
мопс: мопса мопс мопсы 
п: п 
россия: россии россию 
ввоз: ввоз 
животный: животных 
индонезия: индонезию индонезии 
самый: самым самые самое самом самый самых 
простой: простой прост 
трюк: трюк 
жара: жара 
вряд: вряд 
понравиться: понравилось понравилась понравится понравиться понравились 
отец: отца отец 
второй: втором второй вторая вторую 
супруга: супругой 
друг: другу друзьями друга друзьям друзей друг другом 
предприниматель: предприниматель 
неплохо: неплохо 
также: также 
старший: старший 
брат: братом брат 
должность: должность 
британский: британском 
стартапа: стартапе 
индустрия: индустрия 
обсуждать: обсудила обсуждаем обсуждаю 
привязка: привязку 
фунт: фунту 
стерлинг: стерлингов 
дополнительный: дополнительные 
источник: источнике источники источниками 
доход: доходом доходы дохода доход 
пока: пока 
кэшбэк: кэшбэк 
верить: верить 
приложение: приложением приложении приложения приложению приложение 
банка: банка банку 
это: этим это 
понимать: поняли понимаю понимать понять поняла 
разумно: разумно 
сдавать: сдам сдала сдать 
хватить: хватило хватить хватит 
сила: силы 
дух: духе духа 
ждать: жду ждало ждут ждет 
ответ: ответа ответ ответы 
насчет: насчет 
подработка: подработки 
примерно: примерно 
час: часа час часов часам 
складываться: сложится сложились сложилось 
приносить: приносят приносить 
сколько: сколько 
откладывать: откладывает откладываю откладывать отложить 
нисколько: нисколько 
район: району районе района 
выходить: выйти выходить выходило вышло выхожу вышел выходи вышла выйдет выходит 
конец: конца концу конце 
расход: расходах расходом расход расходов расходы 
одинаковый: одинаковы 
повышение: повышение повышением повышения 
становиться: становятся становится стало станете стала 
досрочно: досрочно 
закрывать: закроете закрыть закрывать закрыт 
кредит: кредит кредиты 
наступать: наступили наступает 
февраль: феврале февраль февраля 
разъезд: разъезды 
целое: целом 
уметь: умела умею 
копить: копить 
начинать: начать начинаю начал начала начинать 
исправлять: исправить исправлять 
накапливать: накопила 
классика: классика 
тинькофф: тинькофф 
почему: почему 
удаваться: удалось удается 
тратить: трачу тратила тратить 
слишком: слишком 
активно: активно 
продавать: продают продавать 
акция: акции акций 
очень: очень 
жалко: жалко 
счет: счете счет счетами счетах 
инвесткопилка: инвесткопилке 
особый: особых особой особого 
предпочтение: предпочтения предпочтений 
план: плана планов план плане планах 
удачный: удачных удачные 
покупка: покупками покупок покупка покупки покупку 
связанный: связаны 
биотех: биотехом 
дурацкий: дурацкие 
автопром: автопромом 
часть: часть части 
накопление: накоплениями накоплений 
около: около 
уходить: уйдут уходим уходит уходить ухожу уходило ушел уйти уйдет ушла ушло 
мебель: мебели 
вернее: вернее 
израсходовать: израсходовала 
взять: взяли взяла 
долг: долг долги 
лето: летом 
окончательно: окончательно 
решать: решать решила решают решили решить решаю 
закрываться: закрыться закрывается 
известно: известно 
сотрудник: сотрудники 
смочь: смогут смогу 
купить: купили купила купить купил купленные 
товар: товары 
погасить: погасила 
быстро: быстрее быстро 
буквально: буквально 
везти: повезло 
трудиться: трудилась 
закрытие: закрытием 
благодаря: благодаря 
бонус: бонусам 
работник: работник работников 
обставлять: обставили обставить 
необходимый: необходимого необходимых необходимую необходимое 
большой: большого большой большие большим 
скидка: скидку скидкой скидка 
например: например 
огромный: огромная 
хороший: хорошем хорошая хороший лучшие лучшей лучших хорошей хорошие хороша наилучшим хорошего хорошую наилучшем лучшая 
кухня: кухня 
учитывать: учесть учитывая 
покупать: покупать покупала покупаю 
знать: знал знать знала знаю знаете 
размер: размеров размером 
ситуация: ситуацию ситуация 
оплачивать: оплатить оплачивают оплаченный оплачивала оплатила оплачиваю оплачена оплачивать 
один: одному одном одной одна одних одного одно одну 
покрасить: покрасить 
обои: обои 
заменять: заменить 
место: месте места мест местах местами место 
фотообои: фотообои 
поменять: поменять 
плинтус: плинтуса 
собираться: собралась собиралась собираюсь собраться 
реализация: реализацию 
сложный: сложнейший сложным сложного сложные 
многосоставный: многосоставного 
переезд: переезда переезд переезду 
идеал: идеале 
страна: стран страну 
содружество: содружества 
нужно: нужно 
менее: менее 
расклад: раскладе 
быть: будучи буду будут 
здравомыслящий: здравомыслящим 
человек: человеком человека люди людьми людей человеку человек 
критик: критиком 
натура: натуре 
сильно: сильно 
сомневаться: сомневаюсь 
успех: успехов успехе 
такой: такого такая таким такое таких такие таком 
случай: случае 
подушка: подушку 
безопасность: безопасности 
сторона: сторону стороны 
хотеться: хочется 
чудо: чудеса чудо 
осознавать: осознаю 
одиночка: одиночке 
тридцать: тридцать тридцати 
сложно: сложно сложнее 
проворачивать: провернуть 
получаться: получается получилось получится 
адаптация: адаптация 
оказываться: оказаться оказывается оказалась оказался оказались оказалось оказываюсь оказывалась 
совершенно: совершенно 
выматывать: выматывающей 
попробовать: попробую попробовать 
узнавать: узнаю узнала узнать 
сразу: сразу 
вариант: вариантов варианте варианта 
пытаться: пыталась пытается пытаться пытаюсь пытаются 
реализовывать: реализовать 
одновременно: одновременно 
сначала: сначала 
сосредотачиваться: сосредоточиться сосредоточусь 
экзамен: экзамен экзамена экзамене 
английский: английский английским английского английскому 
они: ними 
делать: делаю делать делая делают 
принцип: принципу принцип 
прикольный: прикольное 
приводить: привело 
дно: дно 
минус: минус 
доллар: долларах 
рубль: рублях 
капелька: капельку 
американский: американского американские 
хотеть: хочет хочу 
неквалифицированный: неквалифицированный 
инвестор: инвестор 
докупать: докупить 
собственность: собственность 
технически: технически 
доля: доля доли 
двушка: двушке 
поскольку: поскольку 
продажа: продажи 
претендовать: претендую 
свой: своей свои свой своего своим своих 
считать: считаю 
отношение: отношения отношение 
видеть: видела вижу 
смысл: смысла смысл смыслах 
документальный: документальном 
оформление: оформлении 
выборгский: выборгском 
петербург: петербурге петербург петербургом петербурга 
недалеко: недалеко 
парк: парка 
оформлять: оформила оформить 
первоначальный: первоначальный 
взнос: взнос 
давать: дать дал дает дала даю давали дают 
бесконечно: бесконечно 
благодарный: благодарна 
стоимость: стоимость стоимостью стоимости 
ставка: ставка 
платить: платил платила платить платит 
богатеть: богатеть 
главный: главным главные 
материал: материалы материалами материалом 
обо: обо 
все: всем 
влиять: влияет 
ваш: вашей ваши вашем 
почта: почте 
среда: средам среда 
суббота: суббота субботам субботу 
бесплатно: бесплатно 
подписываться: подписаться 
регулярный: регулярные 
закидывать: закидываю 
ежемесячный: ежемесячного 
платеж: платежа платежей платежи платеж 
рассрочка: рассрочки рассрочка 
шесть: шесть 
билет: билеты билета билет 
сеул: сеул 
переплачивать: переплачиваю 
обслуживание: обслуживания 
эх: эх 
думать: думала думаю думая 
погода: погода погоде погоды 
сделать: сделало сделала сделай сделают сделать 
изначально: изначально 
март: марта марте 
вылет: вылетом 
пусть: пусть 
заранее: заранее 
обеспечивать: обеспечит 
некоторый: некоторую 
гибкость: гибкость 
позволять: позволяет позволить позволит 
гульнуть: гульнуть 
утро: утра утром 
техника: техниками технику техники 
холодильник: холодильник 
стиральный: стиральную 
машина: машину машины 
посудомойка: посудомойку 
духовка: духовку 
варочный: варочную 
панель: панель 
комбайн: комбайн 
паровой: паровую 
система: систем систему 
моющий: моющий 
пылесос: пылесос 
аналогичный: аналогичные аналогичный аналогичная 
позиция: позицию позиции 
отсутствовать: отсутствуют 
стоять: стояла стоят стоит 
дорогой: дорогой дороже 
разница: разница разницу 
доходить: доходила 
учет: учетом 
переплата: переплаты 
сэкономить: сэкономила сэкономили 
нерв: нервах нервы 
оно: оно 
стоить: стоила стоило 
полгода: полгода 
вносить: внесет вношу внесла внесен 
досрочный: досрочное 
погашение: погашение 
премия: премия 
отдавать: отдавала отдать отдаю 
брать: беру брала берут 
эмоциональный: эмоциональной эмоциональном 
состояние: состояния состоянии состояние 
финансовый: финансовые финансовая 
безалаберность: безалаберность 
семейный: семейное семейной 
образовываться: образовывались 
длительный: длительное 
время: время времени временем 
основное: основном 
коммунальный: коммунальные 
стыдно: стыдно 
пропускать: пропустила 
просто: просто проще 
весь: весь 
ком: ком 
хозяйство: хозяйство 
итог: итогу итоге 
потратить: потратить потратили потратила 
другой: других другим другого другое другие другими другую 
злой: злого 
умысел: умысла 
заплатить: заплатила заплатить 
успеться: успеется 
сам: саму сами самого самих сама 
чувствовать: чувствует чувствуют чувствую 
помогать: помогут помогло поможет помочь помогает 
стабильность: стабильности 
аренда: аренда аренды аренду 
жилье: жилье жилья 
плакать: плачу 
rp: rp 
минута: минуте минут минутах 
скутер: скутера скутере скутер 
центр: центра 
пять: пять 
три: трех 
разный: разный разных разные разную разное разной разным разного 
гест: гесте гест гестах 
находить: нашла найти находить находим нахожу 
нынешний: нынешнее нынешней 
безумно: безумно 
стильный: стильная стильный 
удобный: удобный 
работа: работ работе работу работы работа 
домик: домик домиком домике 
родитель: родители родителям 
отправлять: отправляю 
услуга: услуг услуга услугу услуги 
долговой: долговые 
обязательство: обязательства 
кроме: кроме 
готовый: готова 
нужный: нужны нужную нужен нужное 
разовый: разовые 
крупный: крупные крупной крупный 
сохранять: сохранить 
сумма: суммы сумму сумма 
постоянный: постоянной постоянными 
основа: основе 
обучение: обучение 
часовой: часовой 
урок: уроки урока урок 
дважды: дважды 
ielts: ielts 
ноябрь: ноября ноябре 
try: try 
стамбул: стамбуле стамбула стамбул 
результат: результаты результате 
overall: overall 
ниже: ниже 
поэтому: поэтому 
надеяться: надеюсь 
пересдавать: пересдать 
сожаление: сожалению 
иностранный: иностранным иностранные 
язык: языку языки 
даваться: даются дается 
невероятный: невероятным невероятный 
труд: труда трудом 
учить: уча 
степень: степени степень степенью 
интенсивность: интенсивности 
путаться: путаюсь 
артикль: артиклю артиклях 
забывать: забываю забыла 
окончание: окончание 
глагол: глаголах 
развлечение: развлечение развлечения 
оценивать: оценить 
выделять: выделяю выделила выделен 
сюда: сюда 
входить: входят входит 
кино: кино 
шопинг: шопинг шопингу 
поездка: поездку поездки поездка поездок поездках 
интересный: интересного интереснее интересное интересным интересные интересными 
спот: споты 
снорклинг: снорклинга снорклингом 
близлежащий: близлежащие 
остров: острова остров острове 
пляж: пляжи пляжа пляжем пляж 
заповедник: заповедники 
стараться: стараюсь старалась 
чередовать: чередовать 
длинный: длинная 
короткий: короткий коротких короткие 
выходной: выходные 
ехать: ехать едешь еду едем 
амед: амед амеде 
известный: известный 
ныряние: ныряния 
ловина: ловину 
встречать: встречаю встретить 
дельфин: дельфинов 
третий: третью третьего третий 
вылазка: вылазку 
нус: нуса 
пенид: пенида 
келингкинг: келингкинг 
подъем: подъем 
вулкан: вулкан 
хотя: хотя 
вопрос: вопросы вопрос вопросов вопросом 
любить: люблю любила 
вода: воду водой 
ужасно: ужасно 
плавать: плаваю 
первый: первой первая первые первую первого первый 
попытка: попытка 
плавание: плавания 
маска: маски маску маской 
открывать: открыла открыт 
мир: мир мира 
восхитительный: восхитительный 
фильм: фильмам фильмы фильмах фильм 
кусто: кусто 
заниматься: заняться занималась занимаюсь займутся занимается заниматься занимаемся 
часто: чаще часто 
персональный: персональную персональные 
обычно: обычно 
вести: веду 
стиль: стилях стиле 
комната: комнаты комнату 
совершать: совершай совершаю 
ошибка: ошибку ошибкой ошибка ошибки ошибок 
чрезвычайно: чрезвычайно 
насыщенный: насыщенный 
досуг: досуг 
увлечение: увлечением 
особенно: особенно 
мюзикл: мюзиклы мюзикла мюзиклам 
ковид: ковид 
последующий: последующие 
событие: события событиям событиями 
сводить: свели 
привычка: привычку 
ходить: ходили ходить хожу ходила 
кинотеатр: кинотеатр кинотеатров 
раз: разы раза 
рассказывать: рассказали рассказывать рассказывают рассказать расскажите 
формат: форматом формату 
нравиться: нравится нравятся 
комикс: комиксы 
книга: книгу книга книгой книгах книги 
сериал: сериалы сериалами сериал 
немного: немного 
эпизод: эпизод эпизода 
цеплять: цепляет 
переключаться: переключаюсь 
увлекаться: увлекаюсь 
вышивка: вышивке вышивкой 
работать: работала работает работаю работают работать 
счетный: счетным 
крест: крестом 
вышивать: вышивать вышиваю 
люневильский: люневильским 
крючок: крючком 
гладь: гладью 
рисовать: рисую 
рука: рук руки 
вон: вон 
плохо: плохо похуже 
набор: набор наборов 
посчитать: посчитать 
проект: проекте проекта проект 
схема: схемой 
картина: картине 
альфонса: альфонса 
муха: мухи 
собирать: собираю собраны собирала 
укладываться: уложиться укладываясь уложилась 
лютоволка: лютоволка 
обходиться: обойтись обходится обошелся 
птица: птицей 
аррен: арренов 
любительница: любительницей 
отправляться: отправляюсь отправлялась 
небольшой: небольшая небольшого небольшой небольших небольшую небольшие небольшом 
направление: направлениям 
вроде: вроде 
финляндия: финляндии 
швеция: швеции 
грузия: грузии 
студенчество: студенчестве 
четыре: четырех четыре 
учиться: училась 
обмен: обмену 
франция: франции 
заодно: заодно 
заглядывать: заглядываю заглянула 
испания: испанию испании 
швейцария: швейцарию 
италия: италию 
улетать: улетела 
армения: армению арменией армении 
подождать: подождать 
решение: решению решения 
работодатель: работодателя работодателю 
благо: благо 
значительный: значительной 
покрывать: покрывал 
пробыть: пробыла 
вернуться: вернулась вернуться вернусь 
потихоньку: потихоньку 
составлять: составляя составляет составить 
действие: действий 
загранпаспорт: загранпаспорт 
подготавливаться: подготовиться 
сдача: сдаче 
языковой: языкового 
отпуск: отпуска 
фигурировать: фигурировал 
коллега: коллеги коллег коллегам коллегой коллега коллегами 
шутка: шутку 
ты: тебе 
внезапно: внезапно 
приглянуться: приглянулась 
этот: этих эта 
идея: идей идея идее 
посмотреть: посмотрите посмотрела посмотреть 
цена: цену цены цена 
прикидывать: прикинула прикидываю 
питание: питание 
новый: новый новом новые новой новых новым новую 
мочь: можем могут можешь могу мог 
следующий: следующий следующую следующей следующие следующему 
обратный: обратном обратную обратного обратный 
сгорать: сгораю сгорел 
пересадка: пересадкой 
катар: катаре 
аэропорт: аэропорту 
происходить: произошла происходящего происходящее 
неприятность: неприятность 
вопреки: вопреки 
рекомендация: рекомендациям рекомендации 
бронь: бронь 
потребовать: потребовали 
показывать: показать 
настоящий: настоящий настоящих 
полностью: полностью 
регистрация: регистрации 
попадаться: попавшийся 
приходить: приходит пришла приходят пришло пришел приходим 
отменять: отменен 
попросить: попросила попросили 
агентство: агентства 
перестраховка: перестраховки 
оба: обоих обеих 
компенсировать: компенсировала 
балл: балл баллами баллы балла баллов 
tinkoff: tinkoff 
airlines: airlines 
переводить: переводила перевела перевожу переводить 
вообще: вообще 
дешево: дешевле 
багаж: багаж багажом 
повышать: повысил 
вдвое: вдвое 
коворкинг: коворкинг коворкинге коворкингу коворкингом коворкинга 
бассейн: бассейну бассейном бассейна бассейн 
йога: йогой 
приятный: приятным приятной приятнейшие приятное 
атмосфера: атмосферой 
получать: получу получит получаю получать получила получили получают 
компенсация: компенсацию 
окно: окно окном окнами 
появляться: появились появлялись появилось 
написание: написания написанием 
оттуда: оттуда 
два: две двух двумя 
мамин: маминой мамину 
электричество: электричество электричеством электричества 
указывать: указать укажите 
точно: точно точнее 
потребление: потребление 
счетчик: счетчик 
жилец: жильцы 
пара: пару пары пара парой 
транспорт: транспорт 
весна: весной 
бабушка: бабушки бабушка 
наш: нашего нашу наш наших 
родной: родного 
урал: урале 
село: село 
такси: такси 
выезжать: выезжать выезжаю выехать 
вождение: вождения 
бензин: бензина бензин 
ездить: езжу 
красота: красота 
кожа: кожу кожей кожи 
улучшаться: улучшилось 
выглядеть: выгляжу выглядит 
увлажнять: увлажненной увлажнить увлажненную 
сияние: сиянием 
здоровый: здоровой 
волос: волосы 
маникюр: маникюр 
педикюр: педикюром 
покрытие: покрытия 
долго: дольше долго 
лазерный: лазерную 
эпиляция: эпиляцию 
курс: курса курс 
помешать: помешал 
заканчивать: закончены законченная заканчиваю закончить заканчивать 
пробовать: пробовать пробую 
твердый: твердый 
бюджет: бюджета бюджету бюджет 
уходовый: уходовую 
косметика: косметику косметикой 
декоративный: декоративную 
вульгарный: вульгарные 
блесточка: блесточки 
пользоваться: пользуются пользуюсь пользоваться пользовался 
она: ею её 
рано: раньше рано 
уход: уход ухода 
корейский: корейских 
rose: rose 
shop: shop 
tester: tester 
korea: korea 
доставка: доставка доставку 
равно: равно 
производитель: производителя 
colourpop: colourpop 
посылка: посылка 
затем: затем 
пополнять: пополнила 
запас: запасы 
август: августе 
невестка: невестку невесткой 
отдыхать: отдыхали отдыхала отдыхать 
турция: турции турцию 
средство: средства средств 
origin: origin 
марка: марки 
dr: dr 
jart: jart 
dear: dear 
klairs: klairs 
huxley: huxley 
mi: mi 
elizavecca: elizavecca 
farm: farm 
stay: stay 
список: список 
продолжать: продолжила продолжаю продолжать 
бесконечность: бесконечности 
проблема: проблема проблемой проблему проблемы проблем проблеме 
радикально: радикально 
возвращаться: возвращаются возвращаться возвращаюсь 
корея: корее корею 
окупать: окупить 
постараться: постараюсь 
идеальный: идеальное 
олицетворение: олицетворение 
ожидание: ожидания 
электронный: электронного 
разрешение: разрешения 
въезд: въезд въезда 
никто: никого никто никому 
вставать: встанет встала встаю 
я: мной 
налог: налог налоги 
среднее: среднем 
самозанимать: самозанятая 
продукт: продуктов продукт продукты 
бытовой: бытовых бытовая бытовую бытовые 
химия: химию химия 
готовить: готовить готовлю готовят готовила 
коронный: коронных 
блюдо: блюдах блюд блюдо 
полдюжины: полдюжины 
плюс: плюс 
яичница: яичница 
договоренность: договоренности 
фрукт: фрукты фрукт фруктов 
есть: ем ест ешь 
напиток: напитки 
морепродукт: морепродуктов 
статистика: статистика 
поехать: поехать поехала 
оплата: оплата оплаты оплате оплату 
против: против 
насекомое: насекомое насекомые насекомых 
мытье: мытья 
посуда: посуды 
остальное: остальное 
включать: включаю включить включено включила включены 
относить: отношу 
прачечная: прачечная прачечной 
идеально: идеально 
мало: меньше 
добавлять: добавляю 
остаток: остаток остатка 
завтрашний: завтрашнему завтрашней завтрашнюю 
именно: именно 
ужин: ужина ужине ужином ужин 
ресторан: ресторане ресторана ресторанов ресторан 
завтрак: завтрака завтрак 
ужинать: ужинаю ужинала ужинать 
вне: вне 
дома: дома 
завтракать: завтракаю 
одежда: одежду одежды одежда 
средний: средний среднего 
тот: та тех ту 
ерунда: ерундой ерунду ерунда 
etam: etam 
roxy: roxy 
mango: mango 
забавно: забавно 
последний: последней последнего последний последние 
куртка: куртки 
обувь: обувь 
платье: платья платье 
юбка: юбки 
угодно: угодно 
джинсы: джинсов 
брезговать: брезгую 
вещь: вещами вещи вещей 
мониторить: мониторю 
группа: группы 
bagrain: bagrain 
hunting: hunting 
охота: охота 
выгода: выгодой 
пижама: пижамы 
спортивный: спортивные 
костюм: костюмы 
покидать: покидаю покинула покинул 
ради: ради 
прогулка: прогулку прогулки прогулок 
собака: собаки собаку собак собакой 
спорт: спорт спорта 
скучать: скучаю 
uniqlo: uniqlo 
интернет: интернет 
животное: животные 
ветеринария: ветеринарию 
корм: корм 
вкусняшка: вкусняшки 
столько: столько 
подозревать: подозреваю 
мешок: мешки 
сухой: сухой сухого 
корма: корма 
wolfsblut: wolfsblut 
консервы: консервы 
приходиться: приходится придется пришлось 
мрт: мрт 
операция: операции 
устаканиться: устаканилось 
благотворительность: благотворительность 
системно: системно 
помощь: помощи помощь 
беженец: беженцам 
организовывать: организует 
знакомый: знакомая 
уплата: уплату 
штраф: штрафов 
митинг: митингах митинг митинги 
предпочитать: предпочитаю 
нуждающийся: нуждающимся 
рабочий: рабочие рабочее 
подписка: подписки подписках подписке 
находиться: нахожусь находится 
рф: рф 
недоступный: недоступен 
перебор: перебором 
подруга: подругу подруги подругой 
приостанавливать: приостанавливать 
бессмысленно: бессмысленно 
страховка: страховка страховки 
телефон: телефоном телефон телефоны 
номер: номер 
связь: связь связи 
неравномерный: неравномерная 
строка: строка 
полугодовой: полугодовой 
абонемент: абонемент 
тренировка: тренировки 
занятие: занятия 
еженедельный: еженедельные 
велосипед: велосипеде 
электричка: электрички 
перекус: перекусы 
техобслуживание: техобслуживание 
напряга: напряга 
проезжать: проезжаю 
километр: километров 
главное: главное 
пить: пью пить 
достаточно: достаточно 
давно: давно 
дмс: дмс 
бывший: бывшим бывшей бывшего 
домой: домой 
путешественник: путешественника 
предыдущий: предыдущему предыдущий предыдущего предыдущей 
создавать: создать создаю создало создала 
таблица: таблица таблицу 
распределять: распределяю 
вычитать: вычесть вычитаю 
обязательный: обязательные 
рублевый: рублевую 
половина: половины половину 
индонезийский: индонезийское индонезийскую индонезийского 
делить: делю 
спа: спа 
виза: виза визу визы 
депозит: депозит 
гестхаус: гестхаус гестхаусе 
закладывать: закладываю 
рассчитывать: рассчитываю рассчитывала 
прогуливать: прогулять 
должно: должно 
лихва: лихвой 
наличный: наличные 
использовать: использовала использовать 
конвертик: конвертики 
писать: писала писали пишет писать пишу писал 
весть: вести 
отмечать: отмечено отмечаю отмечу отмечен 
какой: какую какие 
впечатление: впечатления впечатление 
любой: любой любом любых 
вкус: вкус 
фаворит: фаворитов 
crab: crab 
специализироваться: специализируется 
краб: крабах крабов краба 
логично: логично 
правда: правда 
пятница: пятница пятницам 
дело: дела дело 
касаться: касается 
склонность: склонность 
импульсивный: импульсивному 
модель: модель модели моделей 
подумать: подумай подумала подумаю 
пример: пример 
засасывать: засасывают 
насколько: насколько 
заставлять: заставил 
здорово: здорово 
пересматривать: пересмотреть 
подход: подходе подхода подход 
контролировать: контролировать 
резкий: резкое 
дарить: дарит 
надежда: надежду 
четверг: четвергам четверг четверга 
ставить: ставлю 
будильник: будильника будильник 
спать: спать спишь 
настолько: настолько 
возможно: возможно 
удобно: удобнее 
ориентация: ориентацией 
офис: офис 
лондон: лондоне 
восемь: восемь 
скоро: скоро скорее 
ложиться: ложится ложился ложились ложусь 
сегодня: сегодня 
просыпаться: просыпаюсь 
разбудить: разбудил 
писк: писк 
засиживаться: засиживаюсь 
бежать: бегу 
душ: душ 
перебрасываться: перебрасываемся перебрасываюсь 
сообщение: сообщение сообщениями сообщения 
встречаться: встречались встречаюсь встречаться встретимся встречается 
мы: нам 
оперативно: оперативно оперативнее 
класть: кладу 
рюкзак: рюкзак 
зарядный: зарядные 
устройство: устройства 
ноутбук: ноутбуком ноутбук ноутбуку 
вечер: вечером вечера 
бутылка: бутылок бутылками бутылку бутылки бутылкой 
кол: колы кола колу 
глубокий: глубокому 
стыд: стыду стыда 
зависимость: зависимость зависимости 
очередь: очередь очереди 
вторник: вторникам вторник 
лишь: лишь 
десять: десяти десять 
двадцать: двадцати 
медленный: медленный 
осторожный: осторожный 
водитель: водитель 
бесить: бесит 
дорога: дорогу дорога дороге дороги 
успевать: успела успеваю успел 
занимать: занимаю занято занять заняли занимает 
монитор: монитора монитором 
экран: экрана экранов экранам 
разбирать: разбираю 
проверять: проверять проверяю проверены проверить 
накануне: накануне 
релижать: релизить 
бэкенд: бэкенд 
должный: должна должны 
вчера: вчера 
обстоятельство: обстоятельства 
иначе: иначе 
отписываться: отписываюсь отписывается 
счастие: счастью счастье 
образование: образованию 
специалист: специалист специалиста 
печатный: печатной 
реклама: рекламе 
поступать: поступила 
убеждение: убеждением 
переходить: перехожу перешел перейду 
режиссура: режиссуру 
игровой: игрового 
голова: голову головы голове 
глупый: глупую глупые глупых 
специальность: специальность 
поработать: поработала 
съемка: съемках 
ассистент: ассистентом 
режиссер: режиссера 
улечься: улеглось 
университет: университета 
выгорать: выгораю 
seo: seo 
маркетинг: маркетинг 
промежуток: промежуток 
независимо: независимо 
удивляться: удивилась удивились удивляюсь 
то: тому 
тестировщик: тестировщик 
задумываться: задуматься задумалась задумывалась задумываюсь 
убеждать: убеждена 
гуманитарий: гуманитарий 
природа: природе 
подарок: подарок 
рождение: рождения 
курсы: курсы 
тестирование: тестированию тестирования 
довольно: довольно 
спокойный: спокойном 
режим: режиме 
собеседование: собеседованиям собеседования 
хвалить: хвалили 
ругать: ругали 
технический: технические технических технической 
скилла: скиллы 
конкретный: конкретные 
совет: советы 
подтягивать: подтянуть 
оффер: оффер 
полчаса: полчаса 
государственный: государственной 
контора: контору конторе 
сказать: сказал сказать 
начальник: начальника начальник 
отдел: отдела 
единственный: единственный единственной 
гореть: горели 
глаз: глаза глаз 
момент: моменте момент 
поддерживать: поддержали 
отрабатывать: отработала отрабатывает 
девять: девять 
бесполезный: бесполезное бесполезными 
строчка: строчку 
резюме: резюме 
замечательный: замечательной замечательная замечательное замечательного 
наставник: наставника 
полезный: полезного 
вывесить: вывесила 
компания: компанию компании 
чудесный: чудесная чудесную чудесном чудесное чудесных чудесный 
сей: сих 
пора: пор пора 
инженер: инженеры инженер 
благодарить: благодарили 
документация: документацию 
процесс: процессе процесс 
продуктовый: продуктового 
онбординг: онбординга 
член: членам 
команда: команды 
разрабатывать: разработала 
растрогаться: растрогалась 
слезать: слез 
искать: ищет ищу искала 
вместо: вместо 
qa: qa 
тяжело: тяжело 
опыт: опыта опытом 
взаимодействовать: взаимодействовать 
пользовательский: пользовательским пользовательские 
сценарий: сценарии сценариями 
неочевидный: неочевидные 
пользователь: пользователя пользователях пользователей 
баги: баги 
огорчать: огорчает 
расстраиваться: расстраиваться расстраиваюсь 
развиваться: развиваться 
далеко: далеко дальше 
кажется: кажется 
действительно: действительно 
свое: свое 
призвание: призвание 
завтра: завтра 
посвящать: посвятить 
домашний: домашнему 
задание: заданиях задание заданию 
чтение: чтению чтение 
аудирование: аудирование аудированию 
устный: устную 
речь: речью речь 
вероятно: вероятно 
серьезно: серьезнее серьезно серьезней 
разволноваться: разволновалась 
выбиваться: выбилась 
тайминг: тайминга 
цель: цели цель 
мартовский: мартовском 
подымать: поднять 
пункт: пункта пункты 
жалоба: жалобу 
происшествие: происшествие 
супермаркет: супермаркете супермаркет 
эссе: эссе 
последствие: последствия последствиях 
перенаселение: перенаселения 
репетитор: репетитором репетитора репетитор 
н: н 
следить: слежу 
поздно: позже 
чат: чаты 
корень: корень 
оставлять: оставляю оставив оставить 
стол: столе стол 
кабель: кабели 
кафе: кафе 
поторопиться: поторопилась 
сидеть: сижу сидеть сидит 
полка: полок 
ловить: ловлю 
текст: текст тексту 
канал: канал каналы 
пересылать: пересылать 
красивый: красивым красивый красивейшего красивом красивые красивыми красивая 
фото: фото 
отдельность: отдельности 
сентиментальный: сентиментальный 
роман: роман 
снимать: снимают сняли 
виноватый: виноваты 
звезда: звезды 
умирающий: умирающих 
рак: рака 
подросток: подростках 
удивительно: удивительно 
забавный: забавный 
смс: смс 
перекидывать: перекидываю 
gojek: gojek 
объединять: объединяет 
мототакси: мототакси 
миллион: миллион 
лицо: лицу лица 
поочередно: поочередно 
наносить: наносят нанести 
пахнуть: пахнущие 
субстанция: субстанции 
угадывать: угадываю 
измельчить: измельченные 
чайный: чайные 
лист: листья 
массаж: массаж 
плечо: плеч 
отвлекаться: отвлекаться отвлечься отвлекаюсь 
информационный: информационного 
шум: шума 
размышлять: размышляю 
всякий: всяких 
глупость: глупостях 
грешить: грешить 
истина: истине истины 
назад: назад 
бронирование: бронировании 
качество: качестве 
аванс: аванса 
пойти: пошла пойду 
скрабирование: скрабирование 
тело: тела 
салон: салон 
высоко: выше высоко 
точка: точки точку 
четверговый: четверговая 
традиция: традиция 
среди: среди 
экспат: экспатов 
crate: crate 
нечто: нечто 
название: название названием 
please: please 
апельсиновый: апельсиновый 
сок: сок 
выдвигаться: выдвигаюсь 
обратно: обратно 
обманывать: обманывает 
яйцо: яйцо 
пашот: пашот 
кусок: куске 
хлеб: хлеба 
соус: соусом 
песто: песто 
фета: фетой 
авокадо: авокадо 
количество: количества количеством количество количествах 
зеленый: зеленого 
горошек: горошка 
вход: входа 
заскакивать: заскакиваю 
магазинчик: магазинчик 
газировка: газировкой 
минералка: минералкой 
основной: основные основных 
функция: функцию функции функций 
функционал: функционала 
задача: задача задачу задачами задач 
критичный: критичные 
будущее: будущем 
автоматизация: автоматизации 
напоминать: напоминает напоминаю напоминающее 
релиз: релиз релизе релизами 
приезжать: приезжаю приехал приехать 
концертный: концертной 
площадка: площадке 
вечерний: вечерних 
пробка: пробках пробки 
выступление: выступление 
денис: дениса 
чужой: чужого 
больший: большая 
фанатка: фанатка 
стендапа: стендапа 
серия: серии серия серий 
плохой: плохие плохая плохих 
начало: начале начало 
концерт: концерта 
задерживать: задержали 
целый: целый целая 
страдать: страдать страдали страдала 
переписываться: переписываюсь переписывалась 
публика: публики 
зал: зал 
заполнять: заполнен 
процент: процентов проценты 
проходить: проходят прошло прошла проходила прошел пройти проходит 
отлично: отлично 
начинаться: начинается началось 
просить: прошу просит 
нормально: нормально 
прод: проде 
быстренько: быстренько 
выскальзывать: выскользнув 
зала: зала 
путь: пути путь 
заруливать: зарулить 
местный: местный местных местной 
indomaret: indomaret 
специально: специально 
высматривать: высматриваю 
значок: значком 
fresh: fresh 
немой: нем 
продаваться: продаваться 
роскошный: роскошный роскошным 
выбор: выбором выбор 
разум: разум 
требовать: требует 
чипсы: чипсы 
желудок: желудок 
порционный: порционный 
сыр: сыром сыр 
связка: связкой 
бананов: бананов 
булочка: булочкой булочку 
заходить: захожу 
кондиционер: кондиционера кондиционер 
пространство: пространство 
ко: ко 
гость: гости 
зайти: зашел зайти 
паук: паук паукам паука 
ладонь: ладонь 
убегать: убежать убегают 
упасть: упасть 
обморок: обморок 
называть: называемого назвать называют 
охотник: охотником 
опасный: опасен 
снова: снова 
желание: желания желанием 
наблюдать: наблюдаю наблюдать 
наверняка: наверняка 
упоминать: упоминала упомянутый 
случайно: случайно 
привлекать: привлекали привлекает 
мысль: мысль мысли 
азия: азии 
поучаствовать: поучаствовала 
двое: двое 
сутки: суток 
увидеть: увидела 
предоставлять: предоставляет 
обзаводиться: обзавестись 
рубеж: рубежом 
возможность: возможность 
уезжать: уезжает уезжаю уехала уехать 
действующий: действующего 
заграничный: заграничного 
паспорт: паспорт паспорта 
слегка: слегка 
придавать: придавало придает 
уверенность: уверенности 
никакой: никаких 
ереван: еревана ереване 
ребята: ребятами ребят ребята ребятам 
климат: климата 
море: морю 
загран: загран 
нормальный: нормальных нормальный 
уверенный: уверена 
доверенность: доверенностью 
ключ: ключ ключи 
июнь: июне 
текущий: текущие 
сентябрь: сентября 
запланировать: запланированных запланировала 
весьма: весьма 
вовремя: вовремя 
мелькнуть: мелькнула 
присылать: прислал присылает 
восхищаться: восхитилась 
возникать: возникали возник 
завер: завер 
прилетать: прилетела 
продлять: продлить 
полный: полон полную полной 
занятость: занятости 
праздник: праздников праздники 
чистый: чистой чистый 
забронировать: забронирован 
шумный: шумный 
поиск: поиск поиском поиски 
заезжать: заезжаю заехать заехала 
отель: отеля отеле отель 
удовольствие: удовольствием удовольствие удовольствия 
джунгли: джунглях джунглей 
высокий: высокий высокой 
влажность: влажности 
влюбляться: влюбилась 
обстановка: обстановка обстановку 
недостаток: недостатки 
невысокий: невысокий 
уровень: уровень 
мусор: мусору 
бездомный: бездомных 
сыроватый: сыровата 
вкусный: вкусным 
садиться: сажусь сесть 
разбираться: разобраться разбираться разбираюсь 
баг: багу бага багов багом багах баг багами 
подозрительный: подозрительным 
утренний: утренней утренняя утреннюю 
версия: версии версия версию 
увы: увы 
читать: читаем читаю читать читала 
описание: описанием описание 
называться: называется 
девушка: девушки девушке 
выживать: выжила 
авиакатастрофа: авиакатастрофе 
особенный: особенного 
параллельно: параллельно 
вполне: вполне 
терпимый: терпимым 
боковой: боковую 
принимать: принять принимаю 
таблетка: таблетку 
мелатонина: мелатонина 
нервный: нервный 
сон: сна сон сны 
пробуждение: пробуждениями 
выключать: выключаю 
жрать: жрет 
экономить: экономить 
ночь: ночью 
комфортно: комфортно 
энтузиазм: энтузиазма 
валяться: валяемся валяюсь 
кровать: кровати 
спешить: спешить 
некуда: некуда 
получас: получаса 
раскачка: раскачки раскачку 
мемасик: мемасики 
болтовня: болтовня 
новость: новости новостей 
себя: собой 
рутина: рутина 
хлопья: хлопья 
сахар: сахара 
спрашивать: спрашиваю спрашивает 
молоко: молоко молока 
меняться: меняются 
экзотика: экзотика 
смущать: смущает 
разнообразие: разнообразием 
потрясать: потрясает 
подходить: подходящая подходят 
вызывать: вызываю 
laundry: laundry 
boy: boy 
постирать: постирают постиранную 
сортировать: сортирую 
цветной: цветные 
белый: белой белые 
прочитывать: прочитав прочесть 
статья: статьи статье статью 
пояснение: пояснения 
каждый: каждый каждому каждая 
курьер: курьера 
визовый: визовой 
служба: службы 
продление: продление 
скоординировать: скоординировать 
каньон: каньон каньоном 
координатор: координатором 
морока: морока 
мысленно: мысленно 
проклинать: проклинаю 
договариваться: договорились договариваюсь 
ита: ит 
несмотря: несмотря 
обсуждение: обсуждения 
расписка: расписку 
некоторые: некоторым некоторые некоторых 
побегать: побегать 
свободный: свободное 
побеждать: побеждаю победить 
отдельный: отдельного 
доставаться: достается 
справедливо: справедливо 
причина: причину 
изучать: изучаю 
лог: логи 
сравнивать: сравниваю сравнивать 
данные: данные 
успокаивать: успокаивает 
задеть: задело 
крайний: крайней 
мера: мере 
массово: массово 
соображать: соображаю 
семь: семь семи 
бронировать: бронирую 
focus: focus 
room: room 
тариф: тариф 
разминаться: размяться 
круассан: круассаном круассан 
бессмысленный: бессмысленной 
сырой: сырой 
жесткий: жесткий 
даром: даром 
свежий: свежий свежую 
проглядывать: проглядываю 
вчерашний: вчерашнюю вчерашний вчерашняя 
гораздо: гораздо 
слово: слово словам слова слов 
иметь: имеет иметь 
бегать: бегаю 
записывать: записывать 
звук: звук 
мешать: мешать 
помещение: помещении 
багамы: багам 
несчастный: несчастному 
столик: столики 
опускать: опустив 
нога: ноги 
утапливать: утоплю 
привозить: привозят привезет 
крыльцо: крыльце 
стирка: стирку 
перевод: переводом 
gopay: gopay 
богатство: богатство 
идти: иду 
созваниваться: созваниваемся созваниваюсь 
преподаватель: преподаватель преподавателем 
легко: легче легко 
сходиться: сошлись 
минимум: минимум 
ежедневно: ежедневно 
пробный: пробные пробных пробному 
тесто: тесту 
оценка: оценку 
грамматика: грамматика грамматике 
лексика: лексика 
странный: странный странная странного странные 
task: task 
achievement: achievement 
coherence: coherence 
хорошо: получше 
устраивать: устраивает устроил 
превосходный: превосходное 
уставать: устали 
возня: возни 
щипцы: щипцами 
молоток: молотком 
инструмент: инструменты 
отбиваться: отбиться 
крабовый: крабовому 
бургер: бургеру 
десерт: десерты 
чай: чаем 
салат: салат 
поверить: поверить 
вкусно: вкусно 
красиво: красиво 
жар: жару 
цифровой: цифрового 
кочевник: кочевника 
wise: wise 
чаевые: чаевых чаевые 
расходиться: расходимся 
манго: манго 
клубника: клубнику клубника 
низкий: низкая 
касса: кассе 
ценник: ценник ценнике 
перепутывать: перепутали 
порядок: порядок 
цифра: цифр цифры цифрами 
кивать: кивают 
рассыпаться: рассыпаются 
извинение: извинениях 
отвечать: отвечаю ответить 
просьба: просьба просьбе 
разработчик: разработчика 
лениво: лениво 
разделывать: разделывать разделанными 
банан: бананы банан 
тайный: тайный 
ровно: ровно 
т: т 
равнодушно: равнодушно 
относиться: отношусь относятся 
троечка: троечку 
статный: статная 
рыжий: рыжего рыжая 
аж: аж 
зависть: завистью зависть 
берет: берет 
любоваться: любоваться 
самооценка: самооценку 
опаздывать: опаздывающим 
гулять: гуляем 
окрестность: окрестностям 
спуск: спусков 
экскурсовод: экскурсовода 
заведение: заведение заведений 
подавать: подают подали 
кофе: кофе 
лювак: лювак 
убуд: убудом 
поселение: поселением 
парочка: парочка 
мусанг: мусангов 
обитать: обитает 
прямо: прямо 
воля: воли воле 
полтора: полтора полутора 
десяток: десятка десятков 
чашечка: чашечек 
какао: какао 
запивать: запиваю 
рядом: рядом 
качели: качели качелях 
качаться: качается 
кореянка: кореянка 
выдавать: выдают 
взлетать: взлетают взлететь 
обрыв: обрывом 
судя: судя 
жалеть: жалеет 
покачаться: покачаться 
зато: зато 
развеваться: развевается 
роскошно: роскошно 
просматривать: просматриваю 
сайт: сайты сайтом 
предлагать: предлагает 
полежать: полежать 
крюк: крюк 
купальник: купальником 
забирать: заберет 
обед: обеда 
мотоцикл: мотоцикл 
напротив: напротив 
посреди: посреди 
обезьяний: обезьяньей 
свара: свары 
сваливаться: сваливаются 
мимо: мимо 
недолго: недолго 
бой: боем 
волноваться: волнуюсь 
задавливать: задавили 
крыша: крышу 
владелец: владельцем владелец 
отъезжать: отъезжает 
грех: грехи греха 
далекий: подальше далекого 
разговор: разговоры 
взрослый: взрослых 
гавно: говне 
секс: сексе 
когнитивный: когнитивных 
искажение: искажениях 
сознание: сознания 
приятно: приятно 
алексей: алексея 
ракитин: ракитина 
убийство: убийств 
америка: америке 
двадцатый: двадцатого 
век: века 
взгляд: взгляды взгляд 
списываться: списываюсь 
д: д 
замэтчиться: замэтчились 
поболтать: поболтали 
воскресение: воскресенье 
локация: локацию 
позавтракать: позавтракаем 
симпатичный: симпатичную симпатичная 
обещать: обещает 
направляться: направляюсь 
попытать: попытать 
удача: удачу 
храм: храм 
таны: танах 
лот: лот 
спойлер: спойлер 
зря: зря 
выезд: выездом выезде 
притормаживать: притормозить 
полюбоваться: полюбоваться 
праздничный: праздничной 
церемония: церемонии церемонией 
тормозить: торможу 
обочина: обочине 
подрать: подрал 
соседский: соседского 
шпиц: шпица 
песелить: песеля 
строго: строго 
говорить: говорит говоря 
способный: способен способна 
серьезный: серьезный 
вред: вред 
драка: драке дракой 
слабый: слабые слабая 
челюсть: челюсти 
блин: блин 
тяжелый: тяжелый 
верхний: верхней верхняя 
граница: граница границе 
породный: породного 
стандарт: стандарта 
сосед: соседи сосед 
угроза: угрозам 
напасть: напасть 
соперник: соперников 
держать: держит 
защищаться: защищаясь 
связывать: связать 
разрулить: разрулить 
доставать: достать 
отказываться: отказывается 
переругиваться: переругиваемся 
дальнейший: дальнейшую 
каменистый: каменистом 
участвовать: участвует 
судьба: судьба 
близко: ближе 
закат: закат 
жаловаться: жаловаться 
тема: теме тема 
больница: больницы 
пунктуация: пунктуации 
спеллинг: спеллинге 
интервью: интервью 
мэттью: мэттью 
перри: перри 
gq: gq 
домашка: домашки 
вьетнамский: вьетнамский 
попадать: попадаю 
hoian: hoian 
mevui: mevui 
маленький: маленьком маленький маленькие 
суп: суп 
сэндвич: сэндвич сэндвича 
мясной: мясными 
фрикадельки: фрикадельками 
молочный: молочный 
коктейль: коктейль 
стратегический: стратегической 
бадья: бадья 
съедать: съела съедаю 
батарейка: батарейки 
пульт: пульта 
вальхалл: вальхалла 
особо: особо 
ужас: ужасов 
umma: umma 
веко: веки 
сандра: сандра 
спасать: спасает 
концепция: концепций 
запихивать: запихнуть 
пчела: пчелы 
страх: страх 
голубой: голубую 
лагуна: лагуну лагуны 
останавливать: остановит 
ливень: ливень ливня 
уголок: уголок 
отдых: отдыха 
коробка: коробка коробки 
страшный: страшной 
надпись: надписью 
хранение: хранения 
мулине: мулине 
органайзер: органайзер 
нитка: ниток 
игла: игл 
четвертый: четвертый 
сильный: сильнейшего 
подлость: подлости 
обидно: обидно 
солнечный: солнечная 
жаркий: жаркая 
вылезать: вылезать вылезаю 
тюлениться: тюленюсь 
думскроллинг: думскроллинга 
проваливаться: проваливаюсь 
дрема: дрему 
лента: ленте 
мема: мемами 
канальчик: канальчики 
новостной: новостные 
внимательно: внимательно 
провластный: провластными 
оппозиционный: оппозиционными 
погружаться: погружаться 
возвращать: возвращаю 
конверт: конверт 
шаг: шаг 
разделка: разделке 
выбирать: выбрала выбираю выбрать 
незрелый: незрелым 
горький: горьким 
молодец: молодец 
времяпрепровождение: времяпрепровождение 
натыкаться: натыкаюсь 
deadpan: deadpan 
чувство: чувство чувства 
горячий: горячей 
ненависть: ненависти 
очередной: очередной очередную 
грамматический: грамматическое 
правило: правило правилам правила 
куча: кучей 
исключение: исключений 
умещать: уместить 
восторг: восторга 
встреча: встрече 
невероятно: невероятно 
оборот: оборотом 
словом: словом 
стокгольмский: стокгольмского 
синдром: синдрома 
разрывать: разорвать 
never: never 
good: good 
enough: enough 
готовка: готовкой 
кстати: кстати 
понятно: понятно 
интересно: интересно 
назло: назло 
выправляться: выправляется 
селить: селит 
шальной: шальные 
мыслишка: мыслишки 
рвануть: рвануть 
улица: улице 
разгул: разгула 
настоящее: настоящего 
уронить: уроненными 
дерево: деревьями 
молния: молниями 
дикий: дикая 
туда: туда 
вздыхать: вздыхаю 
утешать: утешаю 
гостиница: гостиница 
скромный: скромный 
лодка: лодки 
ласт: ласт 
добираться: добраться 
полдень: полудня 
туламбен: туламбен 
крушение: крушения 
корабль: корабля 
разглядеть: разглядеть 
дайвер: дайверов 
доступный: доступны 
справедливость: справедливости 
лишний: лишнее лишним 
дождь: дождей 
длиться: длились 
уступать: уступали 
дочитывать: дочитала дочитываю 
поискать: поискать 
тренировать: тренировала 
слух: слух 
горничная: горничная 
уборка: уборка 
смена: смена 
постель: постель постели 
недорогой: недорогого 
открытый: открытые 
лоток: лотки 
возле: возле 
гроздь: гроздь 
ориентировать: ориентирован 
цитрусовый: цитрусовые 
ананас: ананасы ананас 
помести: помело 
кожура: кожуру 
кожица: кожицу 
долька: долек 
кола: колой 
придорожный: придорожный 
pepito: pepito 
мандаринка: мандаринки мандаринкой 
питахайя: питахайя 
проба: пробу 
папайя: папайю 
вместе: вместе 
арбуз: арбузом 
улов: улов 
продолжаться: продолжается 
раскладывать: раскладываю 
слушание: слушание слушанию 
набирать: набираю 
большинство: большинство 
орфография: орфографией 
диктовка: диктовку 
буква: буквам 
браться: браться 
ум: ум 
тренироваться: тренироваться 
albert: albert 
интригующий: интригующим 
отделение: отделении отделение 
полиция: полиции 
пропадать: пропавших 
тип: типа 
просмотр: просмотром просмотра 
занятый: заняты 
десятый: десятой 
герой: герой герои 
религиозный: религиозный 
обряд: обряд 
участок: участка 
тупо: тупо 
мерзкий: мерзкие 
сюжетный: сюжетные 
поворот: повороты поворот 
клиффхэнгер: клиффхэнгер 
издевательский: издевательски 
прекрасный: прекрасной 
сюрприз: сюрпризов 
passo: passo 
nook: nook 
намерение: намерением 
выход: выходом 
замечать: замечает замечаю 
жидкость: жидкость жидкостью 
ярмарка: ярмарка 
запружать: запруженной 
пища: пищу 
бог: богов 
стейк: стейка стейк 
тунец: тунцом тунца 
меню: меню 
немногие: немногим 
курица: курицу курицы 
случаться: случается 
гастрономический: гастрономический 
оргазм: оргазм 
он: нему 
рис: рис 
отварный: отварные 
овощ: овощи 
внутренность: внутренность 
положенный: положено 
тающий: тающая 
рот: рту 
дальний: дальней 
тереться: тереться 
толпа: толпе 
комаров: комаров 
мороженое: мороженым 
семя: семя 
intrusion: intrusion 
предсказуемый: предсказуемый 
полночь: полуночи 
пятый: пятый 
понедельник: понедельник 
эффект: эффект 
сниться: снятся 
прокат: проката 
ломаться: ломался 
дописывать: дописываю 
вмешиваться: вмешиваться 
вымирание: вымирание 
вид: видов вид 
терпеть: терпеть 
словоблудие: словоблудие 
противный: противного 
странно: странно 
аргумент: аргумент аргументы 
блок: блока 
огорчаться: огорчаюсь 
менять: меняю 
красный: красного 
малыш: малыша 
черный: черную черный 
шлем: шлем 
падать: падает 
защита: защита 
неудобно: неудобно 
солнцезащитный: солнцезащитных 
очки: очках 
дерганый: дерганым 
скорость: скорость скорости 
тормоз: тормоз 
чувствительный: чувствительный чувствительной 
печалиться: печалюсь 
привыкать: привыкнуть 
расписание: расписание 
созвон: созвон созвона 
планировщик: планировщик 
бэк: бэка 
заводить: завожу 
активный: активными 
смешной: смешная смешную 
тикет: тикет 
обнаруживать: обнаруживаю 
подниматься: поднимаюсь 
туалет: туалета 
пассивный: пассивная 
агрессия: агрессия 
стена: стене 
висеть: висит 
инфографика: инфографика 
сушить: сушить 
бумажный: бумажными бумажные 
полотенце: полотенцами полотенца 
теплый: теплым 
воздух: воздуха воздухом 
экология: экология 
экономия: экономия 
электросушилка: электросушилки 
окей: окей 
болтать: болтаю 
одноклассница: одноклассницей 
л: л 
крутиться: крутятся 
вокруг: вокруг 
разработка: разработкой 
инженерный: инженерных 
частный: частном 
строительство: строительстве 
заказ: заказа заказов 
настроение: настроения 
пессимистичный: пессимистично пессимистичные 
жуткий: жуткая 
гроза: гроза 
дождевик: дождевик 
слушать: слушать слушаю 
дозвон: дозвоне 
короче: коротко 
намечать: намеченными наметила 
наугад: наугад 
паста: пасте пасту 
волшебный: волшебными 
дом: дом 
уютно: уютно 
посидеть: посидеть 
забегаловка: забегаловке 
новое: новое 
pasta: pasta 
bitte: bitte 
быстрый: быстрая 
подача: подача 
наличка: наличку 
мобильный: мобильного 
вслушиваться: вслушиваюсь 
last: last 
us: us 
совмещать: совмещаю 
подарить: подарил 
приставка: приставку 
играть: играла 
оригинал: оригинал 
застревать: застряла 
компьютерный: компьютерных 
игра: игр 
реакция: реакций реакция реакции 
координация: координация 
снятие: снятии 
балагов: балагова 
настраивать: настроена 
ритуал: ритуалов 
шестой: шестой 
боль: боль боли 
коленка: коленкой 
поцарапаться: поцарапалась 
след: след 
отпечатывать: отпечатан 
колено: коленом 
умудряться: умудрилась 
познакомиться: познакомиться 
томкатом: томкатом 
мелкий: мелкое 
похоже: похоже 
муравей: муравья 
обжигать: обжигает 
раздавливать: раздавить 
гугл: гугл гуглу 
воспаление: воспаление воспаления 
интенсивный: интенсивным 
обрабатывать: обрабатываю 
крем: крему кремом 
календула: календулой 
впервые: впервые 
солнце: солнце 
униматься: унимается 
гранола: гранола гранолой 
упаковка: упаковкой 
деликатный: деликатный 
аналог: аналог 
боул: боулах 
вперед: вперед 
поощрять: поощрять 
ребенок: детях дети детей 
конкуренция: конкуренции 
защищать: защищаю 
противоположный: противоположную 
зрение: зрения 
мол: мол 
зашкаливать: зашкаливает 
пасмурный: пасмурной 
обмазываться: обмазываюсь 
переговоры: переговоры 
жительница: жительницей 
согласный: согласна 
колесо: колесо 
этаж: этаже этажах 
выясняться: выясняется 
некорректный: некорректная 
загрузка: загрузка загрузки 
данный: данных 
наличие: наличии наличие 
задействовать: задействован 
сторонний: сторонний 
немало: немало 
выражение: выражений 
самочувствие: самочувствию 
довольный: довольна 
c: c 
расследование: расследования 
обновлять: обновить 
петь: поем 
barn: barn 
сотня: сотен 
метр: метров 
мечтать: мечтала 
пирог: пироге пироги 
карри: карри 
чуточку: чуточку 
расстраивать: расстраивали 
открытие: открытие 
пустой: пустое 
посетитель: посетителей 
чернослив: чернослив 
отличный: отличное 
сочетание: сочетание 
наткнуться: наткнулась 
кукуруза: кукурузу 
счищать: счищенную 
початок: початка 
усилие: усилием 
ограничиваться: ограничиваюсь 
обновляться: обновляется 
возможный: возможный 
исправление: исправления 
метод: метод 
сходить: сходить 
познакомить: познакомить 
интересность: интересностями 
ход: ход 
расслабленная: расслабленные 
беспокоиться: беспокоятся 
детский: детский 
сад: сад 
сладкий: сладкого 
прекрасно: прекрасно 
блистательный: блистательная 
элизабет: элизабет 
мосс: мосс 
секунда: секунды 
актер: актера 
джейми: джейми 
белла: белла 
изменять: изменяет 
память: память 
стивен: стивена 
спилберг: спилберга 
вечность: вечность 
актриса: актрису 
никак: никак 
припоминать: припомнить 
лезть: лезу 
филлип: филлипа 
су: су 
изумительный: изумительного 
захватывать: захватывает 
седьмой: седьмой 
неторопливо: неторопливо 
рутин: рутину 
справедливый: справедлива 
визит: визите 
врач: врачу 
мандарин: мандарин 
зависать: зависаю 
соцсеть: соцсеть 
принадлежать: принадлежат 
meta: meta 
организация: организации 
деятельность: деятельность 
признавать: признана 
экстремистский: экстремистской 
запрещать: запрещена 
территория: территории 
наркозависимость: наркозависимости 
молодежь: молодежи 
излагать: изложить 
мнение: мнение 
четкий: четкие 
формула: формулы 
поставлять: поставить поставлен поставлять 
твой: твое твой 
обоснованный: обоснован 
соответствовать: соответствует 
значение: значение 
повергать: повергает 
уныние: уныние 
чушь: чушь 
пометка: пометки 
вычитывать: вычитываю 
писанина: писанину 
предмет: предмет 
опечатка: опечаток 
ролик: ролик 
ася: аси 
fastrack: fastrack 
толковый: толковую 
информация: информацию 
аспект: аспектам 
произношение: произношение 
умилять: умиляет 
ошибаться: ошибаюсь 
сборы: сборы 
электросчетчик: электросчетчик 
расплата: расплаты 
наставать: настал 
вывозить: вывозить 
обращать: обратила 
внимание: внимание 
особенность: особенности 
внешность: внешности 
занижать: заниженные 
бывать: бывает 
тигровый: тигровая 
расцветка: расцветка 
кошка: кошек 
вытянутый: вытянутый 
разрез: разрез 
равнодушный: равнодушный 
старый: старая 
ротвейлер: ротвейлера 
таить: таю 
поздороваться: поздороваться 
красавчик: красавчика 
пушистый: пушистого 
песик: песика 
переговорка: переговорке 
упоминание: упоминание 
айклауд: айклауда 
перетаскивать: перетащить 
аудиотека: аудиотеку 
библиотека: библиотеки библиотекой 
подкастовый: подкастов 
алиса: алисы 
api: api 
insomnia: insomnia 
проходиться: пройтись 
запрос: запроса запросам 
убеждаться: убедиться 
корректный: корректные 
причем: причем 
необходимо: необходимо 
позитивный: позитивные 
негативный: негативные 
содержание: содержание 
требование: требованиям 
теория: теории 
бесконечный: бесконечное 
наиболее: наиболее 
важный: важные 
вероятный: вероятные 
сортировка: сортировок сортировкой 
объект: объектов 
вывод: вывода 
определять: определяю 
локализовать: локализовать 
водиться: вожусь 
суть: суть 
очевидный: очевидной 
добро: добро 
поотвечать: поотвечали 
злосчастный: злосчастный 
отвлекать: отвлекает 
мозговыносить: мозговыносящей 
долгий: долгой 
база: баз 
рамена: рамен 
пельмень: пельмени 
еда: еды 
задерживаться: задерживаюсь 
пробегаться: пробегаюсь 
поужинать: поужинала 
комиссия: комиссию 
чек: чек 
вводить: ввожу 
код: код 
прошлый: прошлый 
ох: ох 
нагонять: нагоняет 
музыкальный: музыкальной музыкальным 
избирательный: избирательна 
саундтрек: саундтреки 
вокал: вокал 
капелла: капеллу 
фанк: фанк 
легкий: легкий 
рок: рок 
звучание: звучанием 
девяностый: девяностых 
исполнитель: исполнителей 
maroon: maroon 
тейлор: тейлор 
свифт: свифт 
эда: эда 
ширан: ширана 
нойз: нойз нойза 
миленький: миленький 
парень: парень 
иван: иван 
алексеев: алексеев 
выступать: выступающий 
имя: именем 
mc: mc 
минюст: минюстом 
реестр: реестр 
иноагент: иноагентов 
закругляться: закругляться 
почитать: почитать 
подбирать: подберем подобрать 
читатель: читатели 
делиться: делятся 
тэг: тэги 
обложка: обложке 
ксения: ксения 
михайлов: михайлова 
комментарий: комментарии 
модерация: модерацию 
журнал: журнала 
ева: ева 
ц: ц 
феноменальный: феноменальная 
удивлять: удивило 
вменять: вменяемое 
винсент: винсент 
накупать: накупил 
ell: ell 
преуменьшать: преуменьшаете 
достоинство: достоинства 
конформность: конформности 
мать: мать матерью 
паника: панике 
валюта: валюту 
сейлор: сейлор 
марс: марс 
круто: круто 
еще: ещё 
икея: икеей 
ой: ой 
выгружать: выгружала 
реально: реально 
круг: кругами 
враг: врага 
народ: народа 
abstract: abstract 
figure: figure 
извинять: извините 
останавливаться: остановились 
освобождаться: освобождается 
фотография: фотография 
связываться: связаться 
арендатор: арендатором 
сбер: сбера 
зимовка: зимовке зимовку 
отредактировать: отредактировано 
переносить: переносят 
умирать: умереть 
полет: полете 
авиакомпания: авиакомпании 
борт: борт борту 
брахицефал: брахицефалов брахицефал 
французский: французских 
бульдог: бульдогов 
тд: тд 
риск: риск риски 
смерть: смерти 
остальной: остальных 
порода: пород 
верно: верно 
весить: весит 
значит: значит 
ссылка: ссылку 
багажный: багажное 
ванесс: ванесса 
семеновна: семеновна 
хозяин: хозяин 
видимо: видимо 
драматизировать: драматизировали 
потерять: потерял 
puteshestvenitcage: puteshestvenitcage 
многие: многие 
перелет: перелеты 
кот: коты 
многий: многих 
инфаркт: инфаркт 
газлайтер: газлайтер 
топ: топ 
мэм: мэм мэмов 
копилка: копилку 
блестка: блестки 
venividivici: venividivici 
путешествовать: путешествовать 
зимовать: зимовать 
преодолевать: преодолевать 
полезно: полезно 
зп: зп 
смело: смело 
решительно: решительно 
творить: творю 
счесть: сочла 
бред: бредом 
juarhala: juarhala 
повторно: повторно 
скопить: скопить 
максимум: максимум 
собственный: собственного 
говориться: говорится 
офигенный: офигенный 
надежный: надежный 
швейцарский: швейцарские 
часы: часы 
konstantin: konstantin 
solomatin: solomatin 
условный: условный 
выживание: выживания 
отказывать: отказать 
извечный: извечная 
ящер: ящера 
настойчиво: настойчиво 
шептать: шепчет 
компромисс: компромисс 
необходимость: необходимостью 
перспектива: перспектив 
пожить: пожить 
наблюдение: наблюдение 
воспоминание: воспоминания 
сконцентироваться: сконцентироваться 
горизонт: горизонтах 
дмитрий: дмитрий 
россиянин: россиян 
фраза: фразу 
оленька: оленька 
снежный: снежный 
авто: авто 
снег: снега 
почистить: почистила 
прогревать: прогрела 
стекло: стекло 
оттаивать: оттаяло 
навигатор: навигатор 
офигеть: офигела 
попытаться: попыталась 
реальность: реальность 
плюнуть: плюнула 
метро: метро 
ибо: ибо 
тепло: тепла 
переносица: переносица 
завидовать: завидовала 
вспоминать: вспоминая 
напитывать: напитать 
наждачок: наждачку 
темич: темич 
белорусский: белорусских 
биолаборатория: биолабораториях 
creep: creep 
являться: является 
столица: столицей 
великобритания: великобритании 
деталь: детали 
london: london 
capital: capital 
great: great 
britain: britain 
супергерой: супергерой 
входной: входной 
дверь: дверью 
ветер: ветер 
петербургский: петербургском 
впечатлять: впечатляющей 
fun: fun 
fact: fact 
повод: повод 
надобность: надобности 
sheger: sheger 
богатый: богатом 
дракончик: дракончиков 
сын: сын 
мини: мини 
сочинение: сочинение 
favourite: favourite 
food: food 
corm: corm 
контекст: контексте 
писаться: пишется 
спасибо: спасибо 
волк: волк 
страшно: страшно 
изменяться: изменилась 
руководитель: руководителя 
декрет: декрете 
аланья: аланьей 
дежурный: дежурный 
электромонтер: электромонтер 
новосибирск: новосибирске 
экономист: экономист 
москва: москве 
директор: директор 
розничный: розничной 
сеть: сети 
поволжье: поволжье 
пвз: пвз 
оператор: оператор 
установка: установки 
нефтяной: нефтяной 
уфа: уфе 
безработный: безработный 
студент: студент 
сбережение: сбережения 
студентка: студентка 
биоинформатика: биоинформатик 
немецкий: немецком 
киль: киле 
русский: русскому 
белград: белграде 
фрилансер: фрилансер 
кемерово: кемерове 
менеджер: менеджер 
подмосковье: подмосковье 
приволжский: приволжском 
федеральный: федеральном 
округ: округе 
колледж: колледжа 
красноярск: красноярске 
бухгалтер: бухгалтера 
крым: крыму 
мошенник: мошенникам 
понадобиться: понадобились 
справка: справки 
полагаться: полагался 
каникулы: каникулы 
инвалидность: инвалидностью 
уведомлять: уведомлять 
белоруссия: белоруссии 
ипать: ип 
молодой: молодой 
сотрудничать: сотрудничают 
заливать: залили 
дверной: дверную 
ручка: ручку 
замок: замок 
клей: клеем 
протест: протест 
завещание: завещание 
муж: мужа 
имущество: имущество 
здание: здание 
баланс: баланс 
косметичка: косметичка 
комбинированный: комбинированной 
акна: акне 
покупатель: покупателя 
вернуть: вернуть 
срок: срок 
целевой: целевому 
договор: договор договору 
таможня: таможне 
стаут: стауты 
гоза: гозе 
ламбик: ламбики 
крафтовый: крафтовое 
пиво: пиво 
сербия: сербию 
поколение: поколение 
рынок: рынке 
беспроводный: беспроводные 
колонка: колонки 
классный: классные 
apple: apple 
watch: watch 
вакансия: вакансии 
сообщать: сообщить 
контакт: контакты 
политика: политика 
конфиденциальность: конфиденциальности 
пользование: пользования 
ао: ао 
банк: банк 
лицензия: лицензия 
