купить: купить 
акция: акциями акции акций акция 
qiwi: qiwi 
стоимость: стоимость 
сегодня: сегодня 
прогноз: прогноз 
цена: цен цену цена 
котировка: котировками котировки 
график: графике графиками 
динамика: динамика динамику 
курс: курса 
онлайн: онлайн 
банк: банк банке банком 
бизнес: бизнес бизнеса 
касса: касса кассы 
инвестиция: инвестиций инвестиции 
страхование: страхование 
путешествие: путешествия 
город: город 
доля: доле долю долями 
входить: войти войдите 
обзор: обзор 
каталог: каталог 
пульс: пульс пульсе 
аналитика: аналитика 
академия: академия 
скринер: скринер 
терминал: терминалов терминал 
доходность: доходность 
полгода: полгода 
сектор: сектора сектору сектор 
информационный: информационные 
технология: технологии 
мнение: мнению мнения 
новость: новости новостях 
идея: идеи 
компания: компании компанию компания 
plc: plc 
это: этим это 
оператор: оператор 
мгновенный: мгновенных 
платеж: платежей платежи 
который: который которые 
позволять: позволяет 
продавец: продавцам 
принимать: принимать 
оплата: оплата оплату 
электронный: электронные 
виртуальный: виртуальный виртуальные 
кошелек: кошельки 
также: также 
управлять: управляет 
сеть: сетью 
киоск: киосков 
прием: приему 
наличные: наличных наличными 
являться: является 
ведущий: ведущим 
провайдер: провайдером 
финансовый: финансовых 
сервис: сервисы сервисов 
россия: россия россии россию 
страна: страны страна странах 
снг: снг 
биржа: биржа бирже 
торги: торги торгов 
московский: московской московская 
показатель: показатели 
торговый: торговый торговые 
данные: данные данными 
параметр: параметры 
бумага: бумага бумаги бумаг бумагу 
открытие: открытия 
закрытие: закрытия 
дневной: дневной 
диапазон: диапазон 
изменение: изменение 
день: день 
год: годом год году года 
годовой: годовой 
код: код 
идентификатор: идентификатор 
режим: режима 
tqbr: tqbr 
isin: isin 
лотность: лотность 
лот: лот 
квалифицированный: квалифицированных 
инвестор: инвестора инвесторов 
валюта: валют валюта 
rub: rub 
интересный: интересное 
пост: посты 
ionu: ionu 
февраль: феврале февраля 
добро: добра 
все: всем 
кивас: кивас 
вернуться: вернулся 
общий: общем 
фон: фоне 
тренд: тренд 
восходить: восходящий 
сформировываться: сформировался 
думать: думать думаю 
весна: весной 
закрепляться: закрепимся 
долгосрок: долгосрок 
объявление: объявление 
дивов: дивов 
выход: выход 
vtbr: vtbr 
непонятный: непонятный 
слегка: слегка 
верить: верить верю 
сказать: сказал 
замучаться: замучался 
усреднять: усреднять 
время: время 
уменьшать: уменьшить 
хотя: хотя 
выращивать: вырастит 
скоро: скоро 
alrs: alrs 
давить: давят 
хороший: хорошую 
сторона: сторон 
докупаться: докупаться 
ждать: ждать 
геополитика: геополитика 
налаживаться: наладиться 
происходить: происходящему произойдет 
объявлять: объявят объявить 
дива: дивы 
мочь: можете могут 
бюджет: бюджету 
перепадать: перепадает 
тормознуть: тормознет 
передыхать: передохнуть 
новый: новую 
высота: высоту 
вы: вами 
увидиль: увидили 
завтра: завтра 
лето: летом 
очень: очень 
реально: реально 
sber: sber 
sberp: sberp 
просто: просто 
говорить: говорить 
лесенка: лесенкой 
брать: брать 
просадка: просадка 
лишния: лишнии 
появляться: появились 
покупать: покупай 
самый: самый 
надежный: надежный 
вариант: вариант 
стоить: стоить 
счастие: счастья 
профит: профита 
победа: победа 
нужный: нужна 
любой: любой любая 
подходить: подойдет 
попоползти: попоползут 
yverenno: yverenno 
gazp: gazp 
миллер: миллер 
заверять: заверил 
путин: путина путин 
газ: газа 
течение: течение 
долгий: долгих 
десятилетие: десятилетий 
астрономический: астрономические 
обязывать: обязал обязали 
передавать: передавать 
фсб: фсб 
сведение: сведения 
пользователь: пользователей пользователях 
роскомнадзор: роскомнадзор 
вносить: внес 
платежный: платежную 
система: систему 
реестр: реестр реестра 
организатор: организаторов 
распространение: распространения 
информация: информация информации информацию 
сообщать: сообщает 
проект: проект 
ссылка: ссылкой 
уезжать: уехавших 
гражданин: граждан 
становиться: стали стала 
один: одним одной 
немногий: немногих 
способ: способов 
переводить: переводить 
деньги: деньги 
граница: границу 
спрос: спроса спрос 
золотой: золотые 
слиток: слитки 
монета: монеты 
вырастать: вырос 
пять: пять 
сравнение: сравнению 
plzl: plzl 
газета: газета 
financial: financial 
times: times 
мировой: мирового 
приходиться: пришлось 
ft: ft 
лидер: лидерами 
покупка: покупке покупки покупок 
золото: золота 
китай: китай китая 
германия: германия 
индия: индия 
иир: иир 
газпром: газпром 
inwastements: inwastements 
рекомендация: рекомендацией рекомендации 
сильно: сильнее 
влиять: влияют влияющих 
российский: российских российские российском 
ценный: ценную ценные 
правда: правда 
годичный: годичной 
давность: давности 
танцполе: танцполе 
мосбиржа: мосбиржи 
музыка: музыку 
ставить: ставят 
физлицо: физлица 
танцевать: танцуют 
приводить: привело 
рост: росту 
влияние: влияния 
сентимент: сентимент сентимента 
ниже: ниже 
разбирать: разберем 
делить: делим 
мосбиржевский: мосбиржевские 
бумажка: бумажки 
группа: группы 
голубой: голубыми голубые 
фишка: фишками фишки 
среднеликвидный: среднеликвидные 
третьеэшелонный: третьеэшелонный 
шлак: шлак 
манипулировать: манипулировать 
тяжело: тяжело 
телеграмный: телеграмным 
памп: пампом 
далеко: далеко 
сдвигать: сдвинуть сдвинешь 
низколиквид: низколиквид 
достаточно: достаточно 
ошибаться: ошибиться 
нолик: нолик 
выставление: выставление выставлении 
ордер: ордера 
космос: космосе 
вопреки: вопреки 
популярный: популярному 
открытый: открытую 
пампиль: пампили 
наоборот: наоборот 
некоторые: некоторые 
рад: рады 
воровать: ворует 
хлеб: хлеб 
идеальный: идеальный 
выбор: выбор 
манипулирование: манипулирования 
ликвидность: ликвидности 
хватить: хватит 
список: список 
повлиять: повлиял 
доказательство: доказательство 
взять: взяты 
ребята: ребят 
пик: пик 
pikk: pikk 
самолет: самолет 
smlt: smlt 
мать: мать 
дитя: дитя 
mdmg: mdmg 
ozon: ozon 
vk: vk 
vkco: vkco 
однозначный: однозначное 
зло: зло 
удаваться: удастся 
ранний: ранних 
этап: этапах 
распознавать: распознать 
попытка: попытку 
разгонять: разогнать 
актив: актив актива 
разумный: разумных 
предел: пределах 
воспользоваться: воспользоваться 
свой: своей 
голова: головой 
название: название 
зарабатывать: заработать заработали 
текущий: текущая 
вжух: вжух 
улетать: улетели 
январь: января 
фрид: фридом 
финанс: финанс 
последний: последние 
какой: какие каких 
избавляться: избавлялись 
крупный: крупные крупных 
акционер: акционеры акционеров 
фондовый: фондовом 
рынок: рынке 
проходить: прошло 
несколько: несколько 
сделка: сделку сделка сделок 
headhunter: headhunter 
энерго: энерго 
рассказывать: расскажу 
подробно: подробнее 
каждый: каждую 
выходить: вышел 
число: числа 
делиться: делиться 
запрос: запросу 
власть: властей 
interfax: interfax 
бкс: бкс 
экспресс: экспресс 
называть: назвал 
топ: топ 
рф: рф 
среднесрочный: среднесрочную 
перспектива: перспективу 
четверг: четверг 
развивать: развивал 
ралли: ралли 
среда: среду 
подскакивать: подскакивали 
максимум: максимума 
апрель: апреля 
цб: цб 
выдавать: выдал выданы 
универсальный: универсальную универсальная 
лицензия: лицензию лицензия 
банка: банку 
сша: сша 
сделать: сделали 
ставка: ставкой 
работать: работает 
сын: сын 
силуанова: силуанова 
дайджест: дайджест 
обновлять: обновили 
частый: частые 
вопрос: вопросы 
еще: ещё 
относиться: относятся 
такой: такие 
гдр: гдр 
softline: softline 
адр: адр 
циан: циан 
физический: физическому физическим 
лицо: лицу лицам 
приобретать: приобрести 
открывать: открыть открыв 
индивидуальный: индивидуальный индивидуальной 
инвестиционный: инвестиционный инвестиционной 
счет: счет счета счетов 
брокерский: брокерский брокерской 
сайт: сайте сайт 
тинькофф: тинькофф 
представлять: представленные 
доступный: доступна доступны 
торговля: торговля 
шорты: шорт 
маржинальный: маржинальная 
недоступный: недоступна 
похожий: похожие 
личный: личный 
кабинет: кабинет 
другой: другие 
киви: киви 
выпуск: выпуск 
погашение: погашение 
облигация: облигация 
начинаться: начнутся 
час: часов 
составлять: составляет 
рубль: рублей 
производиться: производится 
лонг: лонг 
ознакомляться: ознакомиться 
отслеживать: отследить 
находить: найти 
размер: размере 
дивиденд: дивидендов 
узнавать: узнать 
основной: основных 
инвестировать: инвестировав 
данный: данную 
вложенный: вложенной 
сумма: суммы 
этот: эта 
звонок: звонков 
кредитный: кредитные 
карта: карты 
дебетовый: дебетовые 
премиум: премиум 
кредит: кредит кредиты 
рефинансирование: рефинансирование 
автокредит: автокредит 
вклад: вклады 
подписка: подписка 
pro: pro 
tinkoff: tinkoff 
private: private 
осаго: осаго 
каско: каско 
ипотека: ипотека 
квартира: квартира 
дом: дом 
здоровье: здоровье 
блог: блог 
авиабилет: авиабилеты 
отель: отели 
тур: туры 
билет: билеты 
лететь: лететь 
малый: малый 
расчетный: расчетный 
регистрация: регистрация 
эквайринг: эквайринг 
госзакупки: госзакупки 
продажа: продажи 
бухгалтерия: бухгалтерия 
депозит: депозиты 
проверка: проверка 
контрагент: контрагентов 
бонус: бонусы 
кино: кино 
театр: театры 
концерт: концерты 
ресторан: рестораны 
доставка: доставка 
продукт: продуктов 
салон: салоны 
красота: красоты 
топливо: топливо 
автомобиль: автомобили 
haval: haval 
модель: модели 
jolion: jolion 
f: f 
dargo: dargo 
h: h 
гарантия: гарантия 
большой: большой 
выплата: выплаты выплат 
вэд: вэд 
облачный: облачные 
безналичный: безналичные 
чаевые: чаевые 
отраслевой: отраслевые 
решение: решения 
безопасный: безопасная 
карьера: карьера 
работа: работа 
процесс: процессы 
клиент: клиентами 
иис: иис 
тариф: тарифы 
esim: esim 
перенос: перенос 
номер: номер номера 
роуминг: роуминг 
красивый: красивые 
запись: запись 
секретарь: секретарь 
олег: олег 
точка: точки 
пополнение: пополнения 
банкомат: банкоматы 
курсы: курсы 
контакт: контакты 
помощь: помощь 
investors: investors 
получатель: получателей 
услуга: услуг 
депонент: депонентов 
ао: ао 
осуществление: осуществление 
деятельность: деятельности 
депозитарный: депозитарной 
г: г 
ограничение: ограничения 
срок: срока 
действие: действия 
официальный: официальный 
english: english 
