сообщество: сообщество 
учебник: учебник 
сравнятор: сравнятор 
ипотека: ипотека 
кредитный: кредитная 
история: историей история 
тест: тесты 
дневник: дневники дневник 
трата: трат 
налоговый: налоговая налоговые налоговую налоговый 
вычет: вычет 
написать: написать 
инвестиция: инвестиции 
бизнес: бизнес бизнеса 
разбор: разборы 
закон: законов 
калькулятор: калькуляторы 
путешествие: путешествия 
медицина: медицина 
здоровье: здоровье 
недвижимость: недвижимость 
подкаста: подкасты 
видео: видео 
смотреть: смотреть 
сервис: сервисы 
расчет: расчеты 
закладка: закладки 
письмо: письма 
оставаться: оставайтесь 
деньги: деньгами деньги денег 
поток: потоки 
публиковаться: публикуются 
текст: текст тексты 
наш: наших 
читатель: читателей 
который: которыми которые 
проходить: прошли 
модерация: модерацию 
сюда: сюда 
любой: любой 
сначала: сначала 
стоять: стоит 
изучать: изучить 
правило: правила 
свой: свой своей 
алена: алена 
делать: делать 
мошенник: мошенникам 
понадобиться: понадобились 
справка: справки 
аноним: аноним 
репетитор: репетитор 
полагаться: полагался 
каникулы: каникулы 
платить: платил 
налог: налог налоги 
николай: николай 
человек: человеку человек 
инвалидность: инвалидностью 
копить: копить 
покупать: покупать 
балл: баллы 
дискуссия: дискуссии 
косметичка: косметичка 
andrey: andrey 
belyaev: belyaev 
уведомлять: уведомлять 
счет: счет счетах 
белоруссия: белоруссии 
александр: александр 
павленко: павленко 
работник: работник 
поставлять: поставлять поставить 
товар: товары 
работодатель: работодателю 
ипать: ип 
little: little 
devil: devil 
молодой: молодой 
хотеть: хотите хочет 
оформлять: оформить 
машина: машину 
какой: какие 
риск: риски 
становиться: станьте 
герой: героем 
новое: нового 
материал: материала 
рассказывать: расскажите 
вести: ведете 
конспект: конспекты 
учеба: учебе 
работа: работе работу 
изменяться: изменились 
отношение: отношения 
ваш: вашей 
семья: семье 
рождение: рождения 
ребенок: дети детей ребенка 
усыновлять: усыновили 
взять: взяли 
опека: опеку 
поделиться: поделитесь 
собирать: собираете 
коллекция: коллекцию 
показывать: показать покажите 
лина: лина 
быть: будут 
сотрудничать: сотрудничают 
иностранный: иностранным 
виктория: виктория 
сосед: соседи 
заливать: залили 
дверной: дверную 
ручка: ручку 
замок: замок 
клей: клеем 
протест: протест 
ремонт: ремонта 
надежда: надежда 
завещание: завещание 
муж: мужа 
получать: получать получили 
имущество: имущество 
екатерина: екатерина 
стоимость: стоимости 
здание: здание 
баланс: баланс 
даниела: даниела 
антончук: антончук 
проблема: проблемы проблеме 
багаж: багажом 
возникать: возникали 
поездка: поездках 
сейлор: сейлор 
марс: марс 
уход: уход 
чувствительный: чувствительной 
комбинированный: комбинированной 
кожа: кожей 
акна: акне 
konstantin: konstantin 
последствие: последствия 
покупатель: покупателя 
продавец: продавец 
вносить: внесет 
доля: доли 
арина: арина 
сколько: сколько 
вернуть: вернуть 
обучение: обучение 
отрабатывать: отработала 
срок: срок 
целевой: целевому 
договор: договор договору 
андрей: андрей 
теличко: теличко 
составлять: составить 
процент: проценты 
поступление: поступления 
доход: доход 
farit: farit 
возможный: возможна 
кража: кража 
данный: данных 
использование: использовании 
vpn: vpn 
александров: александрова 
карина: карина 
дом: домом дом 
отец: отца 
право: право 
пользование: пользования 
user: user 
собственник: собственник 
продавать: продать 
прописывать: прописаны 
мы: нам 
некуда: некуда 
идти: идти 
алексей: алексей 
иванович: иванович 
рассчитывать: рассчитывать 
жилищный: жилищную 
субсидия: субсидию 
квартира: квартире 
узнавать: узнает 
дарить: дарят 
личный: личное 
olga: olga 
правильно: правильно 
выплачивать: выплатили 
зарплата: зарплату 
валерия: валерия 
аристова: аристова 
ama: ama 
планировать: планируете 
поменять: поменять 
построить: построить 
успешный: успешную 
карьера: карьеру 
задавать: задайте 
вопрос: вопрос 
эксперт: эксперту 
оксана: оксана 
лосева: лосева 
спорт: спорт спорта 
ненависть: ненависти 
отчаяние: отчаяния 
вид: видов 
занятие: занятие 
приносить: приносит 
удовольствие: удовольствия 
ксения: ксения 
донской: донская 
бюджет: бюджет бюджеты 
помнить: помню 
момент: момента 
кредит: кредита 
контролировать: контролирую 
копейка: копейки 
вакансия: вакансии 
сообщать: сообщить 
проект: проекте 
контакт: контакты 
политика: политика 
конфиденциальность: конфиденциальности 
сайт: сайтом 
выходить: выйти 
ао: ао 
банк: банк 
лицензия: лицензия 
