правило: правилах правила правилам правило 
въезд: въезде въезд въезда 
сербия: сербию сербии сербия 
год: год лет году года 
россиянин: россиянам россиян 
нужный: нужны нужен нужна 
виза: виза визу визы виз 
сертификат: сертификат 
вакцинация: вакцинации 
промой: промо 
заклинание: заклинание 
бесплатный: бесплатную 
кредитка: кредитку 
fgo: fgo 
заказывать: заказать 
карта: карты карт карту 
учебник: учебник 
сравнятор: сравнятор 
сообщество: сообщество 
ипотека: ипотека 
кредитный: кредитная 
история: история 
тест: теста тесты 
дневник: дневники дневник 
трата: трат 
налоговый: налоговые налоговую налоговый 
вычет: вычет 
написать: написать 
инвестиция: инвестиции 
бизнес: бизнес бизнеса 
разбор: разборы 
закон: законе законов закона 
калькулятор: калькуляторы 
путешествие: путешествиями путешествие путешествия 
медицина: медицина 
здоровье: здоровье 
недвижимость: недвижимость недвижимости недвижимостью 
подкаста: подкасты 
видео: видео 
смотреть: смотреть 
сервис: сервис сервисы 
расчет: расчеты 
закладка: закладки 
письмо: письма письмо 
оставаться: оставайтесь оставаться 
деньги: деньгами деньги денег 
поток: потоки 
новость: новости 
путешественник: путешественники путешественников путешественникам путешественник путешественника 
александра: александра 
меньшиков: меньшикова 
знать: знает знать 
попадать: попасть 
профиль: профиль 
автор: автора автор 
один: одна одному одного 
страна: страну стране страна страны стран 
который: который которые которых которой которая которому 
прекращать: прекращали 
авиасообщение: авиасообщение 
россия: россии россией россию 
туда: туда 
улетать: улететь 
напрямую: напрямую 
въезжать: въехать 
нужно: нужно 
сдавать: сдавать 
предъявлять: предъявляют предъявлять предъявить 
коронавирусный: коронавирусные коронавирусных 
ограничение: ограничений ограничениях ограничения 
отменять: отменили 
рассказывать: рассказали рассказывал рассказал расскажу расскажите 
прежде: прежде 
планировать: планировать планирует 
узнавать: узнаете 
регистрация: регистрации регистрация регистрацию 
документ: документы документу документа документами документ 
ребенок: детям дети ребенок детей ребенком 
транзит: транзита транзиту 
банковский: банковские банковского 
отдыхать: отдыхали отдохнуть 
рубеж: рубежом 
указывать: указан укажите 
свой: свои своей 
предпочтение: предпочтения 
подбирать: подберем 
подходить: подходящие подойдет 
пускать: пускают 
российский: российских российские 
турист: туриста туристу турист туристов 
выбирать: выбрать 
гражданин: граждан граждане 
мочь: могут 
находиться: находиться находятся 
день: дня дни день дней 
обнулять: обнулить 
срок: срок 
пребывание: пребывания 
многие: многие 
выезжать: выезжать выезжают 
босния: боснию 
герцеговина: герцеговину 
начинать: начинают 
отсчитывать: отсчитывать 
заново: заново 
сообщать: сообщить сообщили 
друг: друзей друзья другом 
проблема: проблем проблемы проблеме 
делать: делать делали делают 
выезд: выезда выезд 
информация: информации информацию 
часто: чаще 
легализоваться: легализуются 
ст: ст 
соглашение: соглашения 
условие: условиях 
взаимный: взаимных 
поездка: поездки поездок поездкой поездке поездках 
рф: рф 
тот: те теми 
хотеть: хотели хочет 
задерживаться: задержаться 
безвыездный: безвыездно 
долго: дольше долго 
должный: должен должны 
заранее: заранее 
оформлять: оформлял оформить оформляют оформлять 
время: время 
подавать: подать подают 
внж: внж 
вид: виды 
туристический: туристической туристических 
деловой: деловой 
получать: получают получить получать получили 
тип: типа 
разрешать: разрешено 
течение: течение 
каждый: каждом каждого 
период: периода 
качество: качестве 
подтверждение: подтверждения 
цель: целей 
понадобиться: понадобились понадобятся понадобится 
ваучер: ваучер 
гостиница: гостинице гостиницы 
либо: либо 
приглашение: приглашение 
родственник: родственников 
компания: компании 
организатор: организатора 
мероприятие: мероприятия 
учеба: учебы 
работа: работы 
покупка: покупки 
другой: другие других другими 
приходиться: придется 
подтверждать: подтвердить подтверждают 
например: например 
пригласительный: пригласительное 
юридический: юридического 
лицо: лица 
выписка: выписку выписка 
кадастр: кадастра 
заявление: заявления 
большинство: большинство 
консульский: консульском 
отдел: отделе 
посольство: посольства посольство посольствами 
москва: москве москва москвы 
рабочий: рабочей 
портал: портале 
зарегистрироваться: зарегистрируется зарегистрироваться 
картон: картон 
обязанный: обязаны 
место: местах месту мест 
час: часов 
жить: живет жить 
отель: отеле отель 
зарегистрировать: зарегистрируют 
автоматически: автоматически 
останавливаться: останавливается остановился остановиться 
частный: частном 
сектор: секторе 
самостоятельно: самостоятельно 
помощь: помощью 
владелец: владельца 
жилье: жилье жилья 
это: это 
сделать: сделать 
отделение: отделении отделений 
полиция: полиции 
жительство: жительства 
электронный: электронной электронного 
администрирование: администрирования 
иностранец: иностранцах иностранца иностранцев 
pdf: pdf 
кб: кб 
попросить: попросят 
вводить: ввести 
номер: номер 
телефон: телефона телефоны 
адрес: адреса адрес 
почта: почты 
также: также 
личный: личные 
паспортный: паспортные 
данные: данные 
дата: даты дату 
заселение: заселения 
спрашивать: спрашиваем спрашивали спросил спрашивают спросят спросить 
доказательство: доказательства 
владение: владения 
свидетельство: свидетельство 
прийти: придет 
почитать: почту почитать 
оно: оно 
называться: называется 
сербский: сербском сербские 
язык: языке 
потврда: потврда 
приjави: приjави 
боравишта: боравишта 
странец: странца 
грозить: грозит 
штраф: штраф штрафами 
rsd: rsd 
р: р 
оштрафовать: оштрафовать 
реальность: реальности 
бумага: бумаге 
слово: словам 
открывать: открыла открыть 
юрлицо: юрлицо 
счет: счет счета счетах 
банк: банк банков банке 
граница: границе границей границы 
отсутствие: отсутствие 
сталкиваться: сталкивались 
какой: какие 
загранпаспорт: загранпаспорт 
действие: действия 
ссылка: ссылкой 
погранслужба: погранслужбу 
рекомендовать: рекомендует рекомендую рекомендуют 
паспорт: паспортах паспорт 
действовать: действуют действовал 
месяц: месяца 
такой: такие такую 
требование: требованиях требования 
оформление: оформления 
медицинский: медицинская медицинских медицинские 
страховка: страховка страховку 
разниться: разнятся 
прописывать: прописано 
пограничник: пограничник пограничники 
вправе: вправе 
отказывать: отказать 
полис: полиса полис 
сайт: сайте сайтом 
мид: мид 
сказать: сказал сказать сказано 
рекомендоваться: рекомендуется 
минимальный: минимальным 
покрытие: покрытием покрытие 
п: п 
стоимость: стоимость стоимости 
страховой: страхового 
зависеть: зависит 
возраст: возраста 
количество: количества 
проводить: провести провели 
параметр: параметров 
человек: человеку люди человека человек 
обходиться: обходятся обойдется 
зависимость: зависимости 
включать: включено 
лечение: лечения 
covid: covid 
финансовый: финансовой 
состоятельность: состоятельности 
возвращение: возвращения 
третий: третью 
данный: данным 
должно: должно 
сутки: сутки 
показывать: показать 
наличный: наличные 
доказывать: докажет 
требовать: требовать требуют 
снимать: снять сняли снимали снимать 
май: мая 
отрицательный: отрицательный 
результат: результат 
случай: случаях случае 
вписывать: вписан 
взрослый: взрослому взрослого взрослый 
путешествовать: путешествует 
вместе: вместе 
отметка: отметку 
пятилетний: пятилетних 
биометрический: биометрических 
остальной: остальных 
потребоваться: потребуется 
отдельный: отдельной отдельный 
согласие: согласие 
сопровождать: сопровождает 
являться: является 
родитель: родителем 
опекун: опекуном 
усыновитель: усыновителем 
попечитель: попечителем 
бабушка: бабушкой 
брат: братом 
тренер: тренером 
заверять: заверяют 
нотариус: нотариуса 
подробно: подробнее 
тинькофф: тинькофф 
журнал: журнал журнала 
статья: статье статьи статьях 
каков: каковы 
стыковка: стыковки 
назначение: назначения 
проверять: проверяли проверить 
навигатор: навигаторе 
кафе: кафе 
ресторан: рестораны ресторанах 
музей: музеях музея музеи 
заведение: заведения 
работать: работают 
обычный: обычном 
режим: режиме 
посетитель: посетители 
носить: носят носит носить 
маска: масок маски масках 
учреждение: учреждениях 
помещение: помещениях 
обязывать: обязывают 
выпускать: выпускаем выпущенные 
jcb: jcb 
принимать: принимают 
санкция: санкций 
платежный: платежной 
система: системы 
обслуживать: обслуживают 
зато: зато 
unionpay: unionpay 
банкомат: банкоматах 
postanska: postanska 
stedionica: stedionica 
otp: otp 
intesa: intesa 
unicredit: unicredit 
оплачивать: оплачивать 
терминал: терминалах 
наклейка: наклейка 
январь: январе января 
успешно: успешно 
платить: платил платили 
они: ими 
магазин: магазинах магазинов магазины 
аэропорт: аэропорту аэропорт 
белград: белграда белграде белград 
опыт: опыт 
успешный: успешного 
использование: использования 
иностранный: иностранных иностранным 
турция: турции 
беларусь: беларуси беларусь 
денежный: денежные 
перевод: перевода переводы 
корона: корону 
немногий: немногих 
европа: европы 
закрывать: закрыла 
небо: небо 
самолет: самолетов 
сочи: сочи 
город: городов городе город городах 
обратно: обратно 
летать: летают 
прямой: прямые 
рейс: рейсы 
air: air 
serbia: serbia 
единственный: единственная 
европейский: европейская 
авиакомпания: авиакомпания 
продолжать: продолжает 
полет: полеты 
билет: билеты билет 
дорогой: дорогие дороже 
быстро: быстро 
раскупать: раскупают 
март: марте 
перелет: перелет 
стоять: стоит 
около: около 
пересадок: пересадками 
стамбул: стамбуле стамбул 
обычно: обычно 
раз: разу раза 
дешево: дешевле дешево подешевле 
фев: фев 
мара: мар 
купить: купить 
партнерство: партнерстве 
цена: цене цены цена 
багаж: багажа багажом 
обновляться: обновляются 
минута: минут 
подписываться: подписаться 
тэг: тэги 
обложка: обложка 
mareandmare: mareandmare 
shutterstock: shutterstock 
бывать: бывали 
комментарий: комментарии 
проходить: проходят 
модерация: модерацию 
pavla: pavla 
добрый: добрые добрый 
сожаление: сожалению 
возможность: возможность 
практика: практике 
переезд: переезда 
долгий: долгий 
мир: мира 
очень: очень 
искать: ищем 
правительственный: правительственных 
источник: источниках 
сверяться: сверяемся 
консульство: консульствами 
официальный: официальными 
ведомство: ведомствами 
общаться: общаемся 
происходить: происходит 
коллега: коллегами 
захотеть: захочет 
надолго: надолго 
скоро: скорее 
пойти: пойдет 
тема: теме тему 
недавно: недавно 
сша: сша 
германия: германию 
португалия: португалию 
формат: формата 
затрагивать: затрагиваем 
общий: общие 
знание: знание 
выдавать: выдать 
наверняка: наверняка 
никто: никто никому 
повреждать: повредит 
дописывать: дописали 
расстраиваться: расстраивались 
справедливость: справедливость 
восстанавливать: восстановлена 
спасибо: спасибо 
внимательно: внимательно 
читать: читаете 
поделиться: поделились 
способ: способами 
отвечать: ответить 
роман: роман 
яценко: яценко 
два: две 
неделя: недели неделю 
лететь: летели лететь 
пцр: пцр 
обязательно: обязательно 
продуктовый: продуктовых 
крупный: крупных 
торговый: торговых 
центр: центре центрах центр 
свободный: свободно 
курить: курят 
везде: везде 
число: числе 
внутри: внутри 
серб: сербы 
охренеть: охренеть 
высокий: высокие 
девушка: девушки 
красивый: красивые 
одеваться: одеваются 
ярко: ярко 
вызывающе: вызывающе 
пиво: пиво 
местный: местное местным 
балтика: балтики 
вкус: вкус вкусу 
советский: советское 
жигулевский: жигулевское 
помнить: помнит 
район: районе 
парк: парка 
калемегдан: калемегдан 
архитектура: архитектурой 
похожий: похож 
ростов: ростов 
ул: ул 
большой: большой 
садовый: садовой 
горький: горького 
целое: целом 
понравиться: понравился 
продукт: продукты 
доступный: доступные 
обед: обед 
трое: троих 
выходить: выйти выходит 
руб: руб 
высоко: выше 
смешной: смешной 
закрываться: закрывается 
практически: практически 
все: всё 
упаковка: упаковка 
непонятно: непонятно 
анна: анна 
подсказывать: подскажите 
пересадка: пересадка 
хотеться: хотелось хочется 
понятно: понятно 
тесто: тестом 
дважды: дважды 
побыть: побыть 
пара: пару пары 
мед: мед 
угол: углу 
сувенирный: сувенирной 
лавка: лавке 
возле: возле 
галатский: галатской 
башня: башни 
стандартный: стандартную 
елисей: елисей 
костомаров: костомаров 
герой: герой 
середина: середине 
август: августа 
коронавирус: коронавирусе 
вообще: вообще 
кто: кому кого 
нигде: нигде 
кроме: кроме 
тесла: теслы 
кн: кн 
михаил: михаила 
глубокий: глубокой 
ночь: ночей ночи 
толпа: толпы 
народ: народа народу 
swiet: swiet 
дорого: дорого 
мария: мария 
оооо: оооо 
пандемия: пандемии 
думать: думаю 
турспрос: турспрос 
мало: меньше 
вряд: вряд 
задирать: задирают 
любить: любят 
русский: русских 
сколько: сколько 
хотя: хотя 
местой: местой 
валюта: валюте 
тыс: тыс 
рубль: рублей 
двое: двоих 
менее: менее 
пафосный: пафосной 
ivan: ivan 
riabov: riabov 
запрашивать: запросили 
пулково: пулково 
просить: просят 
одевать: одеть 
симпатичный: симпатичный 
достопримечательность: достопримечательность достопримечательностей 
достаточно: достаточно 
море: моря 
швейцария: швейцарии 
плохо: хуже 
становиться: становится 
дешевый: дешевая 
всякий: всяком 
точно: точно 
макдональдс: макдональдса 
видовой: видовых 
ощутимо: ощутимо 
ниже: ниже 
битком: битком 
брать: брали 
машина: машину машине 
иметь: имел 
прокат: прокатом 
накатать: накатали 
км: км 
интересный: интересных 
златибор: златибор 
тара: тара 
фрушка: фрушка 
гора: гора 
суботица: суботица 
палич: палич 
joe: joe 
black: black 
фирма: фирма 
пожалуйста: пожалуйста 
самостоятельный: самостоятельных 
отдых: отдых 
балканы: балканах 
порядок: порядок 
цифра: цифр 
спб: спб 
проживание: проживание 
находить: найти 
апарт: апарты 
тысяча: тысяч тысячи 
причем: причем 
вполне: вполне 
приличный: приличные 
отличный: отличные 
наш: наши нашем наших 
процент: процентов проценты 
транспорт: транспорте транспорт 
хороший: лучшие хорошее 
автобусный: автобусное 
жд: жд 
сообщение: сообщение 
понимать: понимаю 
радиус: радиусе 
передвигаться: передвигались 
он: нему 
сложно: сложнее 
ехать: ехать 
черногория: черногорию черногория 
особый: особых 
голова: головой 
хватить: хватит 
старый: старом 
нравиться: нравится 
берег: берегу 
быть: будут будете 
готовить: готовить 
сам: сами 
недорого: недорого 
получаться: получится 
примерно: примерно 
виктор: виктор 
борисов: борисов 
елена: елена 
петров: петрова 
болгария: болгарии болгарию 
полностью: полностью 
заканчивать: законченный 
вакцина: вакциной 
спутник: спутник 
v: v 
проверяться: проверяются 
довольно: довольно 
ношение: ношение 
общественный: общественных общественные 
видеть: видела 
подбородок: подбородке 
согражданин: сограждане 
мобилизоваться: мобилизуются 
положенный: положено 
рассуждать: рассуждают 
надевать: надевают 
школа: школах 
многолюдный: многолюдные 
временно: временно 
проводиться: проводятся 
пляж: пляжах 
дистанция: дистанция 
стационарный: стационарных 
лежак: лежаков 
зонтов: зонтов 
снижать: снижена 
вдвое: вдвое 
распоряжение: распоряжению 
власть: властей 
писать: писали 
австрия: австрию 
азербайджан: азербайджан 
армения: армению 
албания: албанию 
великобритания: великобританию 
венгрия: венгрию 
греция: грецию 
грузия: грузия 
доминикана: доминикану 
египет: египет 
ирландия: ирландию 
индия: индию 
мошенник: мошенникам 
справка: справки 
репетитор: репетитор 
полагаться: полагался 
каникулы: каникулы 
налог: налог налоги 
инвалидность: инвалидностью 
копить: копить 
покупать: покупать 
балл: баллы 
уведомлять: уведомлять 
белоруссия: белоруссии 
работник: работник 
поставлять: поставлять поставить 
товар: товары 
работодатель: работодателю 
ипать: ип 
молодой: молодой 
риск: риски 
сотрудничать: сотрудничают 
сосед: соседи 
заливать: залили 
дверной: дверную 
ручка: ручку 
замок: замок 
клей: клеем 
протест: протест 
ремонт: ремонта 
завещание: завещание 
муж: мужа 
имущество: имущество 
здание: здание 
баланс: баланс 
возникать: возникали 
косметичка: косметичка 
уход: уход 
чувствительный: чувствительной 
комбинированный: комбинированной 
кожа: кожей 
акна: акне 
последствие: последствия 
покупатель: покупателя 
продавец: продавец 
вносить: внесет 
доля: доли 
вернуть: вернуть 
обучение: обучение 
отрабатывать: отработала 
целевой: целевому 
договор: договор договору 
составлять: составить 
популярный: популярное 
посылка: посылка 
застревать: застряла 
таможня: таможне 
стаут: стауты 
гоза: гозе 
ламбик: ламбики 
пить: пить 
крафтовый: крафтовое 
бали: бали 
зарплата: зарплатой 
мнение: мнение 
поколение: поколение 
девяностый: девяностых 
лишний: лишнее 
рынок: рынке 
труд: труда 
беспроводный: беспроводные 
колонка: колонки 
удачный: удачных 
модель: моделей 
директор: директор 
розничный: розничной 
сеть: сети 
поволжье: поволжье 
экономист: экономист 
дежурный: дежурный 
электромонтер: электромонтер 
новосибирск: новосибирске 
несколько: несколько 
тратить: тратила 
классный: классные 
впечатление: впечатления 
apple: apple 
watch: watch 
вакансия: вакансии 
проект: проекте 
контакт: контакты 
политика: политика 
конфиденциальность: конфиденциальности 
пользование: пользования 
ао: ао 
лицензия: лицензия 
