тест: тестов тест тесты 
жизнь: жизни 
россия: россии 
деньги: деньгах деньгами деньги 
право: правах 
трата: трат тратах 
финансовый: финансовое финансовый финансовой 
грамотность: грамотности 
учебник: учебник 
сравнятор: сравнятор 
сообщество: сообщество 
ипотека: ипотека 
кредитный: кредитная 
история: история истории 
дневник: дневники дневник 
налоговый: налоговый 
вычет: вычет 
написать: написать 
инвестиция: инвестиции 
бизнес: бизнес 
разбор: разборы 
закон: законов 
калькулятор: калькуляторы 
путешествие: путешествия 
медицина: медицина 
здоровье: здоровье 
недвижимость: недвижимость 
подкаста: подкасты 
видео: видео 
смотреть: смотреть 
сервис: сервисы 
расчет: расчеты 
закладка: закладки 
письмо: письма 
оставаться: оставайтесь 
поток: потоки 
проверять: проверьте 
эрудиция: эрудицию 
узнавать: узнать узнайте 
просто: просто 
проводить: проведите 
время: время 
полина: полина 
калмыков: калмыкова 
злободневный: злободневные 
один: одного 
вопрос: вопроса 
сколько: сколько 
российский: российских российские 
мужчина: мужчин 
готовый: готово готовый готовы 
уходить: уйти 
декрет: декрет 
анастасия: анастасия 
советовый: советова 
чутье: чутье 
усадьба: усадьба 
век: века 
угадывать: угадайте 
стоять: стоит 
это: это 
сумасшедший: сумасшедшее 
жилье: жилье 
редакция: редакция 
эрудированный: эрудированных 
кругозор: кругозор 
знать: знать знаете 
должный: должен 
образованный: образованный 
человек: человек 
почитать: почитать 
тот: тех 
хотеть: хочет 
настя: настя 
николаев: николаева 
каков: каков 
ваш: ваш 
гимн: гимн 
подбирать: подберите 
музыкальный: музыкальное 
сопровождение: сопровождение 
денежный: денежных 
дело: дел 
какой: какую 
сумма: сумму суммой 
год: год году 
отказываться: отказаться 
смартфон: смартфона 
дмитрий: дмитрий 
кузьмин: кузьмин 
вероника: вероника 
нецова: нецова 
россиянин: россияне россиян 
потратить: потратить 
ремонт: ремонт 
вика: вика 
вишняков: вишнякова 
многовато: многовато 
сахар: сахара 
есть: едите 
аня: аня 
иванешкина: иванешкина 
кто: кем кому 
работать: работать работают 
который: которые 
часто: чаще 
прогуливать: прогуливали 
школа: школу 
сергей: сергей 
антонов: антонов 
беспощадный: беспощадные 
быть: буду 
относиться: относятся 
разный: разным 
профессия: профессиям 
поддерживать: поддерживает поддерживают 
введение: введение 
единый: единой 
государственный: государственной 
школьный: школьной 
форма: формы 
самый: самых 
поехать: поехавших 
тинькофф: тинькофф 
журнал: журнала 
находиться: находитесь 
никита: никита 
котик: котик 
нечего: нечем 
заниматься: заняться 
праздник: праздниках 
генератор: генератор 
фильм: фильмов 
идеально: идеально 
доедать: доедать 
салат: салаты 
соня: соня 
емельянова: емельянова 
тост: тостов 
читатель: читателей 
находить: найдите 
блеснуть: блеснуть 
новогодний: новогодним новогодней новогоднего 
стол: стола столом 
потерять: потерял 
способность: способность 
мечтать: мечтать мечтают 
оливье: оливье 
маленький: маленьких 
кормить: кормить 
ребенок: дети ребенка 
максим: максим 
иванов: иванов 
ностальгия: ностальгии 
вспомнить: вспомните 
добрый: добрую 
реклама: рекламу 
друковский: друковский 
минута: минут 
добавлять: добавили 
судья: судьи 
матч: матчам 
чемпионат: чемпионата 
мир: мира 
футбол: футболу 
катар: катаре 
насколько: насколько 
необычный: необычный 
ежемесячно: ежемесячно 
свой: своих 
родитель: родителей 
лера: лера 
варпаева: варпаева 
сохранять: сохранить 
книжный: книжный 
гороскоп: гороскоп 
зима: зимой 
ника: ника 
воюцкая: воюцкая 
эмоционально: эмоционально 
зрелый: зрелый 
партнерский: партнерский 
материал: материал 
вакансия: вакансии вакансия 
хороший: лучших 
уметь: умеете 
отличать: отличать 
адекватный: адекватные 
требование: требования 
работодатель: работодателей 
странный: странных 
сообщать: сообщить 
проблема: проблеме 
проект: проекте 
контакт: контакты 
политика: политика 
конфиденциальность: конфиденциальности 
правило: правила 
пользование: пользования 
сайт: сайтом 
выходить: выйти 
ао: ао 
банк: банк 
лицензия: лицензия 
