тинькофф: тинькофф 
журнал: журнал журнала 
авторский: авторская 
рассылка: рассылка 
тот: тех 
хотеть: хочет 
сохранять: сохранить 
сбережение: сбережения 
ясный: ясный 
ум: ум 
первый: первый 
месяц: месяц 
стоять: стоит 
рубль: рублей 
далеко: дальше 
оплачивать: оплатить оплатите 
проверка: проверки 
ваш: вашего ваш вашей ваши ваше 
карта: карты 
списывать: спишем 
следующий: следующие 
платеж: платежи 
быть: будут буду 
списываться: списываться 
соглашаться: согласитесь 
оферта: офертой 
это: это 
работать: работает 
настя: настя насте 
якорев: якорева 
редакция: редакция редакции 
экономить: экономят 
внимание: внимание внимания 
выбирать: выбирают 
самый: самые 
важный: важные важного 
российский: российские 
событие: события 
разбираться: разобрались разбираются 
советоваться: советуются 
эксперт: экспертов экспертами 
рассказывать: рассказывают 
повлиять: повлияют повлиять 
деньги: деньги 
решение: решения 
отвлекаться: отвлекаетесь 
новость: новости 
упускать: упускаете упустили 
каждый: каждый каждую 
четверг: четверг 
получать: получаете получили 
письмо: письма письмо 
разбор: разборами 
совет: советами советы 
мнение: мнениями 
происходить: происходит 
требовать: требует 
внеурочный: внеурочное 
промокод: промокод 
скидка: скидкой 
любой: любой 
курс: курс 
учебник: учебника 
автор: авторе 
раздел: раздела 
экономика: экономике экономики экономика 
год: лет 
писать: писать писала 
бизнес: бизнесе 
государство: государстве 
рбк: рбк 
знать: знает 
кто: кому 
задавать: задавать 
вопрос: вопросы 
чей: чьим 
прогноз: прогнозам 
верить: верить 
слово: слово 
неделя: неделю 
помощь: помощью 
готовить: готовить 
текст: текст 
бюджет: бюджет 
новый: новые 
закон: законы 
экономический: экономические 
тренд: тренды 
правило: правила 
перевод: переводов 
хранение: хранения 
валюта: валюты 
рекомендация: рекомендации 
аналитик: аналитиков 
задача: задача 
сделать: сделать 
читатель: читатели 
сложный: сложном 
комфортный: комфортнее 
переживать: пережили 
трансформация: трансформацию 
предстоять: предстоящий 
мы: нам 
период: период 
называть: называет 
глава: глава 
центробанк: центробанка 
эльвира: эльвира 
набиуллина: набиуллина 
девалютизация: девалютизации 
материнский: материнском 
капитал: капитале 
цена: ценах 
товар: товары 
перспектива: перспективах 
валютный: валютных 
ограничение: ограничений 
распродажа: распродаже 
шенгенский: шенгенских 
виза: визах 
бесплатно: бесплатно 
отписываться: отписаться 
момент: момент 
попробовать: попробовать 
политика: политика 
конфиденциальность: конфиденциальности 
пункт: пункт 
прекращать: прекратить 
подписка: подписку 
