kismet: kismet 
иван: ивана иван 
таврин: таврина таврин таврину 
становиться: становится стал стала 
владелец: владельцем владелец 
headhunter: headhunter 
рбк: рбк 
телеканал: телеканалами телеканал 
pro: pro 
инвестиция: инвестиций инвестиции инвестицией 
мероприятие: мероприятия 
новый: новые новых новая 
экономика: экономика 
тренд: тренды 
недвижимость: недвижимость 
спорт: спорт 
стиль: стиль 
национальный: национальные 
проект: проектов проекты 
город: город 
крипто: крипто 
дискуссионный: дискуссионный 
клуб: клуб 
исследование: исследования 
кредитный: кредитные 
рейтинг: рейтинги 
франшиза: франшизы 
газета: газета 
спецпроект: спецпроекты 
спб: спб 
конференция: конференции 
проверка: проверка 
контрагент: контрагентов 
библиотека: библиотека 
подкаста: подкасты 
политика: политика 
бизнес: бизнес 
технология: технологии технологий 
медиа: медиа 
финансы: финансы 
компания: компании компанию компания компаний 
life: life 
скрывать: скрыть 
баннер: баннеры 
ваш: ваше ваш 
местоположение: местоположение 
выбирать: выбрать 
другой: другое других другие 
весь: весь вся 
мир: мир 
область: область 
екатеринбург: екатеринбург 
новосибирск: новосибирск 
башкортостан: башкортостан 
вологодский: вологодская 
калининград: калининград 
краснодарский: краснодарский 
край: край 
нижний: нижний 
новгород: новгород 
пермский: пермский 
татарстан: татарстан 
тюмень: тюмень 
черноземье: черноземье 
кавказ: кавказ 
карелия: карелия 
мурманск: мурманск 
приморский: приморский 
рубрика: рубрики 
свое: свое 
дело: дело 
деньги: деньги денег 
мнение: мнения 
вход: вход 
регистрация: регистрация 
поиск: поиск 
смена: смена 
регион: регионов региона 
главное: главное 
меню: меню 
вологда: вологда 
краснодар: краснодар 
пермь: пермь 
приморье: приморье 
прямой: прямой 
эфир: эфир 
ошибка: ошибка 
воспроизведение: воспроизведения 
видео: видео 
пожалуйста: пожалуйста 
обновлять: обновите 
браузер: браузер 
банк: банков банк банках 
один: одного одном одной 
сайт: сайте 
лента: лента 
новость: новости новостей 
курс: курса курсу курс 
евро: евро 
февраль: феврале февраль февраля 
eur: eur 
цб: цб 
фев: фев 
доллар: доллара 
usd: usd 
даниил: даниил 
медведев: медведев 
выражать: выразил 
надежда: надежду 
улыбка: улыбку 
дочка: дочки 
победа: победы 
роттердам: роттердаме 
сенатор: сенатор 
сша: сша 
сравнивать: сравнил 
помощь: помощь 
китай: китая 
россия: россии 
покупка: покупке покупка покупкой покупку 
билет: билета 
побеждать: победила победил 
хэм: хэм 
апл: апл 
мюнхенский: мюнхенской 
говорить: говорил говорить говорили 
лидер: лидеры 
постсоветский: постсоветских 
страна: стран 
команда: команда 
old: old 
school: school 
матч: матче 
звезда: звезд 
лига: лиги 
втб: втб 
результат: результате 
стрельба: стрельбы 
тц: тц 
пострадать: пострадали 
двое: двое 
общество: общество 
военный: военной военная 
операция: операции операция 
украина: украине украина 
онлайн: онлайн 
научаться: научитесь 
убедительно: убедительно 
интенсив: интенсиве 
сразу: сразу 
применять: применяете 
знание: знания 
практика: практике 
готовить: готовите 
собственный: собственных собственное 
выступление: выступление 
прокачивать: прокачать 
навык: навык 
конгресс: конгрессе 
призывать: призвали 
предоставлять: предоставить предоставлены предоставила 
истребитель: истребители 
f: f 
косметологический: косметологические 
процедура: процедуры 
манипуляция: манипуляции 
вирсавия: вирсавия 
bloomberg: bloomberg 
узнавать: узнал 
деталь: детали 
санкция: санкций санкции 
против: против 
зеленский: зеленский 
вводить: ввел 
россиянин: россиян 
попросить: попросила 
spotify: spotify 
удалять: удалить 
песня: песни 
российский: российских российские 
артист: артистов 
стоять: стоит 
брать: брать 
кредит: кредита кредит 
правильно: правильно 
погасить: погасить 
ренессанс: ренессанс 
янва: янв 
поделиться: поделиться 
вконтакте: вконтакте 
одноклассник: одноклассники 
capital: capital 
group: group 
головной: головной 
платформа: платформы 
это: это 
второй: второй 
крупный: крупный крупных крупнейших крупные крупного 
портфель: портфеле 
avito: avito 
приобретение: приобретении приобретения 
который: который которая которому которого 
объявлять: объявила 
прошлый: прошлой 
осень: осенью 
hhru: hhru 
купить: купить 
фото: фото 
максим: максим 
стулов: стулов 
тасс: тасс 
получать: получайте полученной получила 
plc: plc 
одноименный: одноименной 
подбор: подбору 
персонал: персонала 
снг: снг 
рассказывать: рассказал 
источник: источника источник 
близкий: близкого близкий ближайшей 
сторона: стороне сторон 
сделка: сделку сделка сделки 
подтверждать: подтвердил 
вопрос: вопрос 
обсуждаться: обсуждается 
несколько: несколько 
час: часов 
выход: выходу выхода 
материал: материала материалы 
выпускать: выпустила 
сообщение: сообщение сообщения сообщении 
следовать: следует 
структура: структура структуру структуры 
капитал: капитала капиталу 
продавать: продал продала 
слово: словам слова 
первый: первого первой первую 
давний: давним 
партнер: партнером партнер 
акционер: акционером акционеров акционера 
goldman: goldman 
sachs: sachs 
посредством: посредством 
партнерство: партнерства 
выступать: выступал 
бенефициар: бенефициаром 
около: около 
владение: владения 
увеличивать: увеличила 
размер: размер 
доля: доли долей долю 
пояснять: пояснил 
собеседник: собеседник 
ранее: ранее 
упоминаться: упоминались 
число: числе число 
опубликовывать: опубликованном 
год: год году лет года годах 
проспект: проспекте 
размещение: размещения размещению размещение 
акция: акции акций 
nasdaq: nasdaq 
говориться: говорилось 
заключать: заключили 
соглашение: соглашение 
должный: должны 
выплачивать: выплачивать 
приблизительно: приблизительно 
любой: любой 
прибыль: прибыли прибыль 
совладелец: совладелец 
выходить: вышел 
радиобизнес: радиобизнеса 
решать: решила 
укреплять: укрепить 
свой: свои своей своих 
позиция: позиции 
давно: давно 
интересоваться: интересуется 
рынок: рынком рынке 
классифайд: классифайдов 
этот: эта 
демонстрировать: демонстрирует 
хороший: хороший 
иметь: имеет 
сильный: сильную 
стратегия: стратегию стратегией 
отмечать: отмечали отметил 
сумма: сумма 
составлять: составляет составила составили 
млн: млн 
финансирование: финансирования финансирование 
называть: назвал 
напоминать: напомнил 
последний: последняя последние 
помимо: помимо 
средство: средств 
привлекать: привлекал 
залог: залог 
иметься: имеющихся 
актив: актива активов активе 
сообщать: сообщала сообщила сообщил 
рыночный: рыночных рыночной 
качество: качестве 
новое: нового 
планировать: планирует 
поддерживать: поддерживать 
существующий: существующую 
рост: росту роста рост 
управлять: управлять 
независимо: независимо 
приводиться: приводятся 
основатель: основатель основателя 
дмитрий: дмитрий 
крюк: крюков 
фонд: фонд фонда 
срок: срок 
жизнь: жизни 
владеть: владела владеет владел 
подходить: подходит 
конец: концу конце 
поэтому: поэтому 
продажа: продажа 
вполне: вполне 
логичный: логична 
перспектива: перспективе 
намерен: намерены 
сохранять: сохранить 
оставаться: оставшиеся 
менее: менее 
правительственный: правительственной 
комиссия: комиссии 
контроль: контролю контроль 
иностранный: иностранных 
рассматривать: рассмотрела рассматривает 
одобрять: одобрила 
направлять: направленных направил 
запрос: запрос 
минфин: минфин 
курировать: курирует 
подкомиссия: подкомиссию 
подобный: подобные 
читать: читайте 
паршивый: паршивый 
почему: почему 
уоррен: уоррен 
баффет: баффет 
пожалеть: пожалел 
станок: станки 
леброн: леброн 
джеймс: джеймс 
тратить: тратит 
здоровье: здоровье 
идти: идут 
минута: минут 
навсегда: навсегда 
избавляться: избавиться 
бесполезный: бесполезных 
совещание: совещаний 
фон: фоне 
противостояние: противостояния 
кнр: кнр 
расти: растет 
взаимный: взаимная 
торговля: торговля 
сей: сих 
пора: пор 
принадлежать: принадлежало 
остальной: остальные 
free: free 
float: float 
прошлое: прошлого 
торговаться: торговались 
американский: американской 
биржа: бирже 
начинать: начала 
специальный: специальной специальных 
торги: торги торгов 
приостанавливать: приостановлены 
продолжаться: продолжаются 
московский: московской 
итог: итогам итоге 
вторник: вторник 
январь: января 
котировка: котировки 
руб: руб 
бумага: бумагу 
исходить: исходя 
капитализация: капитализация 
млрд: млрд 
текущий: текущему текущей 
известный: известен 
очередь: очередь 
телекоммуникационный: телекоммуникационных 
рекламный: рекламных 
возглавлять: возглавлял 
сотовый: сотовой сотового 
оператор: оператора 
начало: начале 
приобретать: приобрели приобрел 
павел: павла 
дурова: дурова 
соцсеть: соцсетью соцсети 
месяц: месяца месяцев 
пакет: пакета пакет 
благодаря: благодаря 
что: чему 
условие: условиям 
тот: той 
также: также 
опцион: опцион 
впоследствии: впоследствии 
реализовывать: реализовывать 
отводить: отведенные 
заплатить: заплатили 
средний: средней средних среднего 
потерять: потерял 
стс: стс 
среди: среди 
башенный: башенной 
вышка: вышками 
оборудование: оборудования 
связь: связи 
договариваться: договорилась 
раскрываться: раскрывалась 
известно: известно 
лишь: лишь 
пбк: пбк 
оценивать: оценена оценили 
представитель: представитель 
финансироваться: финансироваться 
сбербанк: сбербанка 
расчет: расчет расчетом 
он: нему 
организовывать: организованы 
консорциум: консорциумом 
глава: главе 
россельхозбанк: россельхозбанком 
развиваться: развивается 
выручка: выручки выручка 
девять: девять 
доступный: доступные 
данные: данные 
вырастать: выросла 
сравнение: сравнению 
аналогичный: аналогичным 
предыдущий: предыдущим 
период: периодом 
чистый: чистая 
снижаться: снизилась снизилось 
раз: раза 
неопределенность: неопределенность 
отношение: отношении 
будущее: будущего 
экономический: экономического 
развитие: развития 
геополитический: геополитических 
событие: событий 
приводить: привела 
уменьшение: уменьшению 
количество: количества 
платить: платящих 
клиент: клиента клиентов 
малый: малых 
компенсировать: компенсировало 
увеличение: увеличение 
сегмент: сегменте сегментах 
ежегодный: ежегодной 
индексация: индексации 
цена: цен 
мера: мер 
повышение: повышение 
монетизация: монетизации 
общий: общее 
пользователь: пользователей 
тыс: тыс 
раскрывать: раскрыл 
youdo: youdo 
май: мае 
ход: ходе 
ipo: ipo 
инвестор: инвестора инвесторы 
близко: близко 
верхний: верхним 
ожидание: ожиданиям 
момент: момент 
остановка: остановки 
равняться: равнялась 
руководитель: руководитель 
алексей: алексей 
замес: замесов 
абсолютный: абсолютный 
монополист: монополист 
ниша: нише 
скоро: скорее 
исчерпывать: исчерпала 
возможность: возможности 
быстрый: быстрого 
рывок: рывок 
показывать: показала 
небольшой: небольшой 
органический: органический 
оценка: оценка 
мультипликатор: мультипликатора 
х: х 
ebitda: ebitda 
выглядеть: выглядит 
справедливый: справедливой 
дисконт: дисконта 
рассуждать: рассуждает 
время: время 
подчеркивать: подчеркнул 
устойчивый: устойчива 
ситуация: ситуаций ситуации 
служить: служит 
пример: примером 
давать: давать 
стабильный: стабильный 
дивидендный: дивидендный 
поток: поток 
широкий: широком 
диапазон: диапазоне 
означать: означать 
центр: центром 
неполитизированный: неполитизированные 
пусть: пусть 
конкретный: конкретных 
план: планов 
последующий: последующему 
кроме: кроме 
очевидно: очевидно 
денежный: денежный 
ресурс: ресурс 
консервативный: консервативной 
дополнять: дополнил 
эксперт: эксперт 
точка: точки 
зрение: зрения 
стратегический: стратегического 
миноритарный: миноритарного 
оправдывать: оправданной 
длительный: длительном 
горизонт: горизонте 
нормализация: нормализацию 
макроэкономический: макроэкономической 
активизация: активизацию 
труд: труда 
особенно: особенно 
принимать: принимая 
внимание: внимание 
сохраняться: сохраняющиеся 
лидировать: лидирующие 
указывать: указала 
старший: старший 
аналитик: аналитик 
анна: анна 
курбатова: курбатова 
автор: авторы 
тег: теги 
балашов: балашова 
ирина: ирина 
парфентьев: парфентьева 
участие: участии 
екатерина: екатерина 
ясаков: ясакова 
подписываться: подпишись 
vk: vk 
быстро: быстрее 
тема: теме 
негативный: негативном 
влияние: влиянии 
работа: работу 
попадать: попал 
реестр: реестр 
организатор: организаторов 
распространение: распространения 
информация: информация информации 
зафиксировать: зафиксировал 
неуверенность: неуверенности 
контактный: контактная 
редакция: редакция редакции 
реклама: рекламы 
социальный: социальные 
сеть: сети 
youtube: youtube 
telegram: telegram 
дзен: дзен 
подписка: подписки 
comfort: comfort 
уведомление: уведомления 
rss: rss 
оповещение: оповещения 
ios: ios 
android: android 
продукт: продукты 
домен: домены 
хостинг: хостинг 
медиапоиск: медиапоиск 
анализ: анализ 
знакомство: знакомства 
ограничение: ограничениях 
правовой: правовая 
соблюдение: соблюдении 
авторский: авторских 
правый: прав 
юридический: юридическая 
ао: ао 
сетевой: сетевого 
издание: издания 
федеральный: федеральной 
служба: службой 
надзор: надзору 
сфера: сфере 
информационный: информационных 
массовый: массовых 
коммуникация: коммуникаций 
номер: номером 
эл: эл 
сопровождаться: сопровождаются 
пометка: пометкой 
мировой: мировых 
финансовый: финансовых 
инструмент: инструментов 
reuters: reuters 
отправлять: отправить 
выделять: выделите 
часть: часть 
текст: текста 
статья: статье 
нажимать: нажмите 
