жилье: жилье 
полезный: полезные 
статья: статьи 
покупка: покупка покупке покупкой покупку 
аренда: аренда аренду 
квартира: квартиры квартиру квартирой квартире квартир 
оформление: оформление 
защита: защиту 
правый: прав 
собственник: собственников 
съемщик: съемщиков 
учебник: учебник 
сравнятор: сравнятор 
сообщество: сообщество 
ипотека: ипотеку ипотека ипотеки 
кредитный: кредитная 
история: историй история 
тест: тесты 
дневник: дневники дневник 
трата: трат 
налоговый: налоговый 
вычет: вычет 
написать: написать 
инвестиция: инвестиции 
бизнес: бизнес 
разбор: разборы 
закон: законов законах 
калькулятор: калькуляторы 
путешествие: путешествия 
медицина: медицина 
здоровье: здоровье 
недвижимость: недвижимость недвижимости 
подкаста: подкасты 
видео: видео 
смотреть: смотреть 
сервис: сервисы 
расчет: расчеты 
закладка: закладки 
письмо: письма 
оставаться: оставайтесь 
деньги: деньгами деньги 
поток: потоки 
продажа: продаже продажа 
раздел: раздел 
тот: тех 
арендовать: арендует 
покупать: покупает 
продавать: продал продать продает продавал продали 
alexander: alexander 
четыре: четыре 
дома: дома 
какой: какими 
проблема: проблеме проблемами 
сталкиваться: столкнулся 
новостройка: новостройке 
анастасия: анастасия 
корнилов: корнилова 
получать: получить 
краткий: краткая 
инструкция: инструкция 
мэл: мэл 
чикал: чикалов 
нужный: нужны 
нотариус: нотариуса нотариусов 
дистанционно: дистанционно 
доля: доли долей долю долями 
почитать: почитать 
жкх: жкх 
ремонт: ремонт 
обустройство: обустройство 
людмила: людмила 
соколовский: соколовская 
купить: купил купила купили 
программа: программе 
бюджетник: бюджетников 
константин: константин 
каупуш: каупуш 
совет: советов 
зимний: зимний 
сезон: сезон 
максим: максим 
чурилов: чурилов 
зарабатывать: заработать 
срочный: срочном 
выкуп: выкупа выкупе 
советовый: советова 
однушка: однушку 
детский: детскими 
взамен: взамен 
двушка: двушку 
упрощение: упрощение 
незначительный: незначительной 
другой: другие 
изменение: изменения 
ольга: ольга 
лурье: лурье 
итог: итоге 
пузырь: пузырь 
лопнуть: лопнет 
недостаток: недостатков 
господдержка: господдержкой 
проверять: проверить 
застройщик: застройщика 
хватова: хватова 
верить: верьте 
агентство: агентству 
слово: слово 
турция: турции 
долг: долгом 
бывший: бывшего 
владелец: владельца 
тамара: тамара 
скоков: скокова 
разрешение: разрешение 
опека: опеки 
снимать: снять сняли 
счет: счета 
ребенок: ребенка 
рубашевский: рубашевская 
норвегия: норвегии 
страивать: строю 
третий: третий 
против: против 
стоять: стоит 
пользоваться: пользоваться 
услуга: услугами услуг 
риелтор: риелтора риелторов 
оформлять: оформить 
дарственный: дарственную 
мария: мария 
беликов: беликова 
таракан: тараканами 
москва: москве 
юлия: юлия 
скопич: скопич 
быстро: быстрее 
приезжать: приезжай 
загородный: загородный 
дом: дом 
м²: м² 
пригород: пригороде 
екатеринбург: екатеринбурга 
даниил: даниил 
захаров: захаров 
высчитывать: высчитывал 
микродоля: микродоли 
маткапитал: маткапиталу 
наиграться: наигрался 
занимательный: занимательную 
математика: математику 
анна: анна 
гриневич: гриневич 
змея: змеи 
жара: жара 
плесень: плесень 
месяц: месяцев 
пхукет: пхукете 
сменить: сменила 
ирина: ирина 
половодова: половодова 
грозить: грозят 
махинация: махинации 
договор: договором 
судебный: судебных 
запрещать: запретить 
сделка: сделки 
личный: личного 
присутствие: присутствия 
госуслуга: госуслуги 
елена: елена 
солдаткин: солдаткина 
гольяново: гольяново 
глаз: глазами 
местный: местных 
житель: жителей 
стоимость: стоимость 
привязывать: привяжут 
прожиточный: прожиточному 
минимум: минимуму 
регион: регионах 
артем: артем 
бетев: бетев 
переуступка: переуступке 
недостраивать: недостроенную 
вакансия: вакансии 
сообщать: сообщить 
проект: проекте 
контакт: контакты 
политика: политика 
конфиденциальность: конфиденциальности 
правило: правила 
пользование: пользования 
сайт: сайтом 
выходить: выйти 
ао: ао 
банк: банк 
лицензия: лицензия 
