какой: какие каких 
российский: российскому российским российские российская российский российских российском российской российского 
бумага: бумагами бумаги бумаг бумагу 
избавляться: избавился избавлялись избавилась 
крупный: крупные крупных крупнейшим 
акционер: акционеру акционер акционера акционеров акционерам акционеры 
год: лет году года 
промой: промо 
дарить: дарит 
акция: акциями акцию акции акций 
регистрация: регистрацию 
мочь: могу могли могут мог 
получать: получить получать получили 
учебник: учебник 
сравнятор: сравнятор 
сообщество: сообщество 
ипотека: ипотека 
кредитный: кредитная кредитной 
история: история 
тест: тесты 
дневник: дневники дневник 
трата: трат 
налоговый: налоговые налоговую налоговый 
вычет: вычет 
написать: написать 
инвестиция: инвестиции инвестициями 
бизнес: бизнес бизнеса 
разбор: разборы 
закон: законов закону 
калькулятор: калькуляторы 
путешествие: путешествия 
медицина: медицина 
здоровье: здоровье 
недвижимость: недвижимость 
подкаста: подкасты 
видео: видео 
смотреть: смотреть 
сервис: сервиса сервис сервисы 
расчет: расчеты 
закладка: закладки 
письмо: письма 
оставаться: осталось оставайтесь 
деньги: деньгами деньги денег 
поток: потоки 
инвестразбор: инвестразборы 
headhunter: headhunter 
group: group 
plc: plc 
hhr: hhr 
купить: купленного купить 
адр: адр 
циан: циан 
cian: cian 
р: р 
qiwi: qiwi 
спб: спб 
биржа: биржа 
spbe: spbe 
эл: эл 
энерго: энерго 
enru: enru 
партнерство: партнерстве 
тинькофф: тинькофф 
котировка: котировок котировки 
обновляться: обновляются 
минута: минут 
фондовый: фондовом фондовая 
рынок: рынок рынке 
проходить: проходят прошедшие прошло прошла прошедшей 
несколько: несколько 
сделка: сделке сделку сделок сделка сделки 
рассказывать: расскажу расскажите 
подробно: подробнее 
каждый: каждую 
никита: никита 
компанищенко: компанищенко 
частный: частный 
инвестор: инвесторам инвесторы инвестор инвесторов 
профиль: профиль 
автор: автора 
начало: начале 
январь: январе января 
объявлять: объявил 
смениться: сменился 
контролировать: контролирующий 
бывший: бывший 
основной: основные основной 
собственник: собственник собственника собственников собственники 
инвестиционный: инвестиционного инвестиционному инвестиционный 
фонд: фонд фонду фонда 
elbrus: elbrus 
capital: capital 
продавать: продал продать продав продавать продала 
большой: большую 
часть: часть части 
свой: свои своего свой своих 
группа: группы группе 
kismet: kismet 
который: который которые которого которая которому 
становиться: стала 
обладатель: обладателем 
доля: долей долю доля доли доле 
снижаться: снизится снизилась 
примерно: примерно 
данный: данным 
январский: январская 
приличный: приличным 
дисконт: дисконтом 
текущий: текущие текущая текущей 
рыночный: рыночной рыночная 
цена: цене цена 
инвесткомпания: инвесткомпания 
заплатить: заплатила 
млн: млн 
рекрутинговый: рекрутингового 
около: около 
доллар: долларов 
млрд: млрд 
рубль: рублей 
соответствовать: соответствует соответствовало 
биржевой: биржевых биржевая биржевые 
компания: компании компания компаний 
мосбиржа: мосбирже 
высоко: выше 
район: районе 
вырастать: выросли 
ждать: ждет 
февраль: феврале февраля 
продажа: продажи продаже 
продолжаться: продолжились 
американский: американским американский американскому 
банк: банк 
goldman: goldman 
sachs: sachs 
сообщать: сообщить сообщил 
уставный: уставном 
капитал: капитала капитале 
сокращаться: сократилась 
предположительно: предположительно 
пакет: пакета пакет 
выкупать: выкупил выкупив выкупить 
свободный: свободном 
обращение: обращении 
источник: источник 
редакция: редакция 
советовать: советует 
инвестировать: инвестировать 
быстрый: быстрые 
нескучный: нескучные 
урок: уроки 
вкладывать: вкладывать 
ум: умом 
изучать: изучить 
середина: середине 
выходить: вышли выйти вышел 
состав: состава 
принадлежащий: принадлежащие 
платежный: платежного 
имя: имя 
покупатель: покупателя 
раскрывать: раскрыто раскрыли 
ранее: ранее 
организация: организации 
принадлежать: принадлежит принадлежала принадлежало 
класс: класса 
голос: голосов 
стоимость: стоимость стоимости 
составлять: составляет составить 
сергей: сергей 
солонина: солонин 
выставлять: выставил 
два: две двум 
оферта: оферта оферты 
держатель: держателям 
очень: очень 
низкий: низкая низкой 
главный: главным 
образ: образом 
объясняться: объясняется 
отсутствие: отсутствием 
альтернатива: альтернатив 
конец: конца конце 
торги: торги торгов 
приостанавливать: приостановлены 
сша: сша 
frank: frank 
media: media 
энергогенерирующий: энергогенерирующего энергогенерирующая 
актив: активы 
это: это 
электростанция: электростанций 
среднеуральский: среднеуральская 
невинномысский: невинномысская 
конаковский: конаковская 
грэс: грэс 
азовский: азовская 
кольский: кольская 
вэс: вэс 
предприятие: предприятие предприятия 
итальянский: итальянской 
enel: enel 
октябрь: октября 
зарубежный: зарубежный зарубежными зарубежная 
владеть: владел 
россия: россии 
нефтяной: нефтяной 
новый: новые новых 
поделить: поделили 
равный: равна равной 
пропорция: пропорции 
полностью: полностью 
самый: самым 
консолидировать: консолидировав 
рука: руках 
вынужденный: вынужден 
отправлять: отправить 
все: всем 
остальной: остальным 
обязательный: обязательное 
предложение: предложения предложение 
покупка: покупке 
превышать: превысила 
новое: нового 
сильно: сильно 
впечатлить: впечатлила 
момент: момента 
публикация: публикации 
упасть: упала упали 
параметр: параметры 
тип: тип 
гарант: гарант 
корпорация: корпорация 
срок: срок 
действие: действия 
день: дней 
получение: получения 
март: марта 
счет: счет счета счетах 
поступать: поступят 
апрель: апреля 
uroc: uroc 
limited: limited 
ооо: ооо 
заявлять: заявил 
банка: банку 
депозитарный: депозитарных 
расписка: расписок 
дубайский: дубайскому 
broomfield: broomfield 
international: international 
впервые: впервые 
отображаться: отобразилась 
ближневосточный: ближневосточному 
mpoc: mpoc 
technologies: technologies 
максим: максим 
мельников: мельников 
второй: вторая 
величина: величине 
считаться: считается 
организатор: организатором 
иностранный: иностранными иностранные иностранный иностранным 
ценный: ценными 
страна: стране 
относительно: относительно 
недавно: недавно 
публичный: публичной 
ipo: ipo 
состояться: состоялось 
размещение: размещения 
торговый: торговой 
площадка: площадке площадки 
freedom: freedom 
finance: finance 
квартал: квартале 
сведение: сведения 
учитывать: учитывая 
время: время 
брокер: брокер 
выручать: выручил 
операция: операции 
менее: менее 
миллиард: миллиарда 
кроме: кроме 
май: мае 
втб: втб 
уведомлять: уведомил уведомлять 
полный: полной 
деталь: детали 
решать: решили 
разглашать: разглашать 
вероятно: вероятно 
риск: риска риски 
санкция: санкций санкциями 
число: числа 
ноябрь: ноябре 
находиться: находились 
итог: итоге 
рассматривать: рассмотренная 
пятерка: пятерка 
аутсайдер: аутсайдеры 
капитализация: капитализация 
месяц: месяцев 
фон: фоне 
распродажа: распродажи 
нерезидент: нерезидентами 
практически: практически 
хотеть: хотели хочет 
этот: этих 
уходить: ушли 
именно: именно 
поэтому: поэтому 
близкий: ближайшее 
увидеть: увидеть 
спекулятивный: спекулятивный 
рост: рост 
эмитент: эмитентов 
напрямую: напрямую 
уход: уход ухода 
количество: количество 
продавец: продавцов продавец 
новость: новости 
касаться: касаются 
наш: нашем 
подписываться: подписывайтесь 
курс: курсе 
происходить: происходящего 
тэг: тэги 
фотография: фотография 
обложка: обложке 
istock: istock 
комментарий: комментарии 
модерация: модерацию 
правило: правилам правила 
журнал: журнала 
andre: andre 
macareno: macareno 
герой: герой 
смысл: смысле 
она: её 
понятно: понятно 
переписывать: переписали 
кореш: корешей 
отвечать: ответить 
мошенник: мошенникам 
понадобиться: понадобились 
справка: справки 
репетитор: репетитор 
полагаться: полагался 
каникулы: каникулы 
платить: платил 
налог: налог налоги 
человек: человеку человек 
инвалидность: инвалидностью 
копить: копить 
покупать: покупать 
балл: баллы 
белоруссия: белоруссии 
работник: работник 
поставлять: поставлять поставить 
товар: товары 
работодатель: работодателю 
ипать: ип 
молодой: молодой 
оформлять: оформить 
машина: машину 
быть: будут 
сотрудничать: сотрудничают 
сосед: соседи 
заливать: залили 
дверной: дверную 
ручка: ручку 
замок: замок 
клей: клеем 
протест: протест 
ремонт: ремонта 
завещание: завещание 
ребенок: дети детей 
муж: мужа 
имущество: имущество 
здание: здание 
баланс: баланс 
проблема: проблемы проблеме 
багаж: багажом 
возникать: возникали 
поездка: поездках 
косметичка: косметичка 
чувствительный: чувствительной 
комбинированный: комбинированной 
кожа: кожей 
акна: акне 
последствие: последствия 
вносить: внесет 
сколько: сколько 
вернуть: вернуть 
обучение: обучение 
отрабатывать: отработала 
целевой: целевому 
договор: договор договору 
процент: проценты 
популярный: популярное 
неделя: неделю 
посылка: посылка 
застревать: застряла 
таможня: таможне 
делать: делать 
стаут: стауты 
гоза: гозе 
ламбик: ламбики 
место: мест 
пить: пить 
крафтовый: крафтовое 
пиво: пиво 
москва: москве 
жить: живет 
бали: бали 
зарплата: зарплатой 
въезд: въезда 
сербия: сербию 
россиянин: россиян 
мнение: мнение 
поколение: поколение 
девяностый: девяностых 
лишний: лишнее 
труд: труда 
хороший: лучшие 
беспроводный: беспроводные 
колонка: колонки 
удачный: удачных 
модель: моделей 
директор: директор 
розничный: розничной 
сеть: сети 
поволжье: поволжье 
экономист: экономист 
дежурный: дежурный 
электромонтер: электромонтер 
новосибирск: новосибирске 
тратить: тратила 
классный: классные 
впечатление: впечатления 
apple: apple 
watch: watch 
вакансия: вакансии 
проект: проекте 
контакт: контакты 
политика: политика 
конфиденциальность: конфиденциальности 
пользование: пользования 
сайт: сайтом 
ао: ао 
лицензия: лицензия 
