сравнятор: сравнятор 
учебник: учебник 
сообщество: сообщество 
ипотека: ипотека 
кредитный: кредитная 
история: история 
тест: тесты 
дневник: дневники дневник 
трата: траты трат 
налоговый: налоговый 
вычет: вычет 
написать: написать 
инвестиция: инвестиции 
бизнес: бизнес 
разбор: разборы 
закон: законов 
калькулятор: калькуляторы 
путешествие: путешествия 
медицина: медицина 
здоровье: здоровье 
недвижимость: недвижимость 
подкаста: подкасты 
видео: видео 
смотреть: смотреть 
сервис: сервисы 
расчет: расчеты 
закладка: закладки 
письмо: письма 
оставаться: оставайтесь 
деньги: деньгами 
поток: потоки 
тот: тех 
выбирать: выбрать выбирает 
покупать: покупает 
обоснованный: обоснованные 
рекомендация: рекомендации 
товар: товаров 
обзор: обзоры 
личный: личный 
опыт: опыт 
подтверждать: подтвержденным 
отзыв: отзывам 
виктория: виктория 
зорина: зорина 
хороший: лучшие 
раствор: растворы 
контактный: контактных 
линза: линз 
хукабур: хукабура 
покупка: покупки 
ребенок: дети ребенка 
советовать: советую 
родитель: родителей родителям 
doona: doona 
кадерль: кадерлем 
косметичка: косметичка 
уход: уход 
комбинированный: комбинированной 
кожа: кожей 
лицо: лица 
тело: тела 
волос: волос волосами 
год: лет году 
почитать: почитать 
работа: работы работа 
зарплата: зарплата 
бюджет: бюджета бюджет 
экономия: экономия 
город: город 
даниил: даниил 
баздырев: баздырев 
беспроводный: беспроводные 
колонка: колонки 
удачный: удачных удачные 
модель: модели моделей 
стас: стас 
зверян: зверянов 
картридер: картридер 
купить: купить 
артем: артем 
соколов: соколов 
гейнер: гейнеры 
набор: набора 
мышечный: мышечной 
масса: массы 
владимир: владимир 
ноженко: ноженко 
читатель: читатели 
собирать: собирают 
компьютер: компьютеры 
потратить: потратил 
сборка: сборку 
пк: пк 
жалеть: жалею 
никита: никита 
богуславский: богуславский 
apple: apple 
watch: watch 
юлия: юлия 
скопич: скопич 
газовый: газовые 
плита: плиты 
mr: mr 
wolf: wolf 
чувствительный: чувствительной 
акна: акне 
месяц: месяц 
электронный: электронные 
книга: книги 
дамир: дамир 
камалетдинов: камалетдинов 
какой: какие 
airpods: airpods 
ольга: ольга 
щербинина: щербинина 
dyson: dyson 
подарок: подарок 
венедиктов: венедиктов 
саундбары: саундбары 
умный: умные 
любой: любого 
александр: александр 
герасимов: герасимов 
ноутбук: ноутбуки 
новый: новых 
китайский: китайских 
бренд: брендов 
айпад: айпад 
евгений: евгений 
матвеев: матвеев 
использовать: использую 
мастерская: мастерской 
который: которой 
работать: работаю 
каждый: каждый 
день: день 
планировать: планирую 
останавливаться: останавливаться 
наталья: наталья 
пыленка: пыленок 
превращать: превратить 
дом: дом 
склад: склад 
игрушка: игрушек 
совет: советов 
оксана: оксана 
мосеева: мосеева 
тональный: тональные 
крем: кремы 
ирина: ирина 
фурсов: фурсова 
ухаживать: ухаживаю 
обезвоживать: обезвоженной 
телевизор: телевизоры 
стол: столы 
дополнительный: дополнительными 
функция: функциями 
кирилл: кирилл 
черемисин: черемисин 
внешний: внешние 
жесткий: жесткие 
диск: диски 
hdd: hdd 
ssd: ssd 
вакансия: вакансии 
сообщать: сообщить 
проблема: проблеме 
проект: проекте 
контакт: контакты 
политика: политика 
конфиденциальность: конфиденциальности 
правило: правила 
пользование: пользования 
сайт: сайтом 
выходить: выйти 
ао: ао 
банк: банк 
лицензия: лицензия 
