жить: живу живет жить жила жил живут жили живете живем 
директор: директором директорами директоров директор директору 
розничный: розничной 
сеть: сети сетей сеть 
поволжье: поволжье 
зарплата: зарплатой зарплаты зарплата зарплате зарплату 
промой: промо 
кредитка: кредитки кредитке 
день: дня днем день дни дней 
заказывать: заказывает заказываю заказанный заказала заказать 
карта: картой карте карты картам карту 
учебник: учебник 
сравнятор: сравнятор 
сообщество: сообществе сообщество 
ипотека: ипотеку ипотека 
кредитный: кредитная кредитной 
история: историю история 
тест: тесты 
дневник: дневники дневник дневника дневнике 
трата: траты трат 
налоговый: налоговые налоговую налоговый 
вычет: вычет 
написать: написали напишу написан написать напишет 
инвестиция: инвестициями инвестициях инвестиций инвестиции инвестициям 
бизнес: бизнесов бизнес бизнесы бизнесу бизнеса 
разбор: разборы 
закон: законов 
калькулятор: калькуляторы 
путешествие: путешествие путешествия 
медицина: медицина 
здоровье: здоровье 
недвижимость: недвижимость недвижимости 
подкаста: подкаст подкасты 
видео: видео 
смотреть: смотрят смотрю смотрит смотрела смотреть 
сервис: сервис сервисы 
расчет: расчет расчеты 
закладка: закладки 
письмо: письма 
оставаться: оставайтесь остается остаться осталась остался остались 
деньги: деньгами деньгам деньги денег 
поток: потоки 
общий: общим общие общее общий общей 
доход: доходом доход доходам доходе доходы доходами доходов дохода 
семья: семья семьи семье 
середина: середине середины 
январь: январе января 
год: год году лет года годах 
посторонний: посторонним 
зарабатывать: зарабатываете зарабатывает заработать 
р: р 
профиль: профиль 
автор: автора автор автору 
возраст: возраст возрасте 
город: городе город городам городу 
областной: областной 
центр: центр 
родитель: родители родителями родителей родителям 
мама: маме мамой мамы мама 
папа: папе 
работать: работала работает работаю работают работать работал 
получать: получал получить получаем получит получать получили получают получает получил 
пенсия: пенсию 
младший: младшая 
сестра: сестры сестрой сестра 
отдельно: отдельно 
должность: должность должности 
близкий: близка ближайшим ближайшие 
коммерческий: коммерческому 
правда: правда 
специфический: специфическом 
место: месте места мест местам местах место 
любимый: любимая любимого 
девушка: девушки девушка девушкой 
семилетний: семилетний 
сын: сын сыну сыном 
первый: первая первой первые первую первого первый 
брак: брака брак 
быть: будут буду будете будем 
называть: назвать называю называть 
выходной: выходным выходные выходных 
проводить: провели проводят проводит проводить проводим провожу проводили 
вместе: вместе 
небольшой: небольшого небольшой небольшое небольшая 
региональный: региональной 
условно: условно 
говорить: говорит говорим говоря 
сфера: сфере сферах сферы 
fmcg: fmcg 
товар: товара товарах товарам товаров товаром товары товар 
повседневный: повседневного 
спрос: спроса 
месяц: месяцев месяц месяца месяцами месяцу 
теоретически: теоретически 
должный: должна должен должным должны 
приходить: пришли приходит пришла пришло прийти пришел приходим 
годовой: годовой 
бонус: бонусы бонусам бонусом бонус 
выгрызать: выгрызаю 
собственник: собственников собственники собственник собственниками 
суммарный: суммарный 
составлять: составил составить 
млн: млн 
премия: премия 
март: март марте 
четвертый: четвертая четвертый 
квартал: квартал 
вообще: вообще 
удаваться: удалось удается 
добывать: добыть 
наш: нашего наши нашу нашей нашим наша нашем 
привыкать: привыкла привык привыкли 
то: тому 
договоренность: договоренностей договоренности 
пересматривать: пересмотрел пересматривать 
приходиться: приходится придется пришлось 
настаивать: настаивать 
довольно: довольно 
жестко: жестко 
соблюдать: соблюдали 
целое: целом 
рекордный: рекордная рекордным 
возможно: возможно 
такой: такая такого таким такое таких такие таком 
повторяться: повторится 
понимание: понимание 
вести: ведет веду 
цель: цели цель 
который: который которой которых которые которого которую которая которыми котором которое которым которому 
далеко: дальше 
эйчар: эйчаром эйчар 
услуга: услуг 
кроме: кроме 
основный: основного 
менять: меняю менять менял меняли меняет 
неделя: неделю неделе неделей недели 
несколько: несколько нескольких 
проект: проекте проекта проектов проект 
подбирать: подбирает подберем подобрать 
сотрудник: сотрудники сотрудников сотрудникам 
компания: компании компанией компаний 
аудит: аудит 
кдп: кдп 
она: ею неё её 
восхищаться: восхищаюсь 
трудиться: трудился трудились трудится 
считать: считаю считает считать считал считайте считали 
особо: особо 
заработок: заработка 
исходить: исходил 
сколько: сколько 
платить: платили платить платила платят платит платил 
тот: те та тех 
часто: чаще часто 
занимать: займет занять занимает 
начальник: начальника начальником начальник 
специалист: специалиста 
весьма: весьма 
неплохо: неплохо 
регион: региона регионах регионе региону 
точно: точно 
знать: знал знали знать знаю знает 
сумма: сумма сумму 
разный: разный разных разным разная разными 
среднее: среднем 
сменить: сменил сменит 
работа: работе работу работы работа работой 
должно: должно 
выходить: выйти выходить вышло вышли выхожу вышел выходит 
менее: менее 
точный: точную 
цифра: цифры цифру 
узнавать: узнаем узнавать узнала 
полный: полная полную 
дополнительный: дополнительное дополнительные 
источник: источники источник 
дивиденд: дивиденды 
х: х 
retail: retail 
group: group 
кэшбэк: кэшбэки кэшбэком кэшбэка кэшбэк 
специально: специально 
очень: очень 
неравномерный: неравномерный 
около: около 
процент: процентов процент проценты 
вклад: вкладам вкладах вклады вкладе 
давать: дали давайте дадут дают 
пара: пару пары 
главный: главная главную главным главные главный 
вопрос: вопросу вопросы вопросов вопросах вопрос 
кто: кем кого 
брать: беру брать берем брал 
думать: думал думать думаю думаем 
мой: моем моих мое мои моей 
итог: итоге итог итоги 
примерно: примерно 
одинаковый: одинаковым 
меняться: меняется 
столько: столько 
вдвоем: вдвоем 
откладывать: откладывал откладываю отложил отложить откладывать 
отправлять: отправил отправили отправлю отправляю отправим отправлять 
накопление: накопления накоплениями накоплениях накоплений 
это: этим этому это 
учет: учетом учет учета 
реинвестировать: реинвестированного 
накоплять: накопленного накопил 
учитывать: учитываю учтешь 
капитал: капитал капитале 
последний: последним последний последние 
поэтому: поэтому 
приводить: приведу приведет привели 
декабрь: декабре декабря 
иис: иис 
лежать: лежат лежит 
остальное: остальное 
другой: другое других другим другую 
брокерский: брокерским брокерских брокерский брокерские брокерском 
счет: счет счетов счетах счете счетам счету счета 
тинькофф: тинькофф 
рубль: рублях рублей 
хороший: хорошая лучшие лучшим хорошей хорошее лучшую лучшая 
ставка: ставка 
май: мая 
самый: самую самая самое самом самый самых 
низкий: низкая 
июнь: июня 
средний: средний среднюю среднего 
наверное: наверное 
наличные: наличных наличными 
пополам: пополам 
доллар: доллар доллары 
подушка: подушка 
безопасность: безопасности 
нал: налом 
сентябрь: сентября 
накопительный: накопительный накопительных накопительным 
текущий: текущей текущие текущим текущему текущем 
палата: палате палату 
замораживать: заморожен заморожены заморожена 
фонд: фондов фонды 
уезжать: уехал уезжаем уезжал уехали уезжать уехать 
золотой: золотая золотые 
инвестиционный: инвестиционная инвестиционный 
монета: монета 
победоносец: победоносец 
вес: вес весом 
г: г 
купить: купит купили купила купить купил 
курс: курсов курсу курсе курс курса 
правило: правило правилу правилам правила 
приносить: принесли принесла приносить приносит 
основной: основное основная основные основную основной 
основное: основном 
российский: российские 
акция: акции акция 
облигация: облигаций облигации 
немного: немного 
часть: частей часть 
биржевой: биржевые 
металл: металлы 
планировать: планируем планировать планирую 
заново: заново 
открывать: открываю открыть открыли открыл открывать 
структурировать: структурировать 
портфель: портфель портфеле 
сожаление: сожалению 
сдуру: сдуру 
наделать: наделал 
субсчет: субсчетов 
брокер: брокера 
понимать: понял понимаешь понимал понимает понимаю понимать понять 
реальность: реальности 
неудобно: неудобно 
пока: пока 
второй: вторая второй второму вторую 
изначально: изначально 
предполагать: предполагал 
сделать: сделать сделаю сделанная 
пассивный: пассивный пассивным 
etf: etf 
переезжать: переезжал переезжать переехал переедете 
момент: моментов моменту момент 
останавливаться: остановились останавливаемся 
торги: торги 
достигать: достигнут достигнет 
вычеркнуть: вычеркну 
верить: верю 
пять: пять 
разблокировать: разблокируют 
состоять: состоит 
индекс: индекса 
мосбиржа: мосбиржи 
золото: золото 
зпиф: зпиф 
сложность: сложности 
доводить: довести 
оставлять: оставили оставляю оставлю оставить 
вид: видов вида виде 
десять: десять 
ребалансировать: ребалансируя 
рублевый: рублевых 
хотя: хотя 
сильно: сильно 
увеличивать: увеличил увеличить 
вложение: вложения 
ценный: ценных ценные 
бумага: бумаги бумаг 
оцениваться: оценивался 
конец: концы концу конца концами конце 
сильный: сильный сильной 
просадка: просадки просадка 
стоить: стоила стоил стоить 
четыре: четыре 
ноль: ноль 
постоянно: постоянно 
пополнять: пополняю 
доходность: доходность 
считаться: считается 
корректно: корректно 
максимальный: максимальной максимальная максимальное 
отношение: отношения отношению 
вносить: внесет внес внесенным 
результат: результат результаты результатом результате 
фиксировать: фиксирую 
рынок: рынок рынке рынка 
доля: доля доли доле долю 
собственность: собственности собственность 
всякий: всякие всяким 
телефон: телефона телефонов телефон телефоны телефоне 
бук: буки бук 
дрон: дроны 
прочее: прочее 
имущество: имуществом имущества имущество 
расходник: расходники расходников 
четверть: четверть 
трехкомнатный: трехкомнатной 
квартира: квартирах квартиры квартиру квартира квартире квартир 
один: одному одном одной одна одного одним одно одну 
пустой: пустая 
двушка: двушка 
хрущевка: хрущевке 
категорически: категорически 
хотеть: хотел хотели хочет хотят хотим хочу 
поскольку: поскольку 
слово: слово словах слова слов 
вроде: вроде 
принадлежать: принадлежать принадлежит 
договариваться: договорились договариваемся договориться договариваться 
продавать: продал продать продает продаст продали продавать продайте 
жилье: жилье 
сдавать: сдавать 
аренда: аренды аренду 
семь: семь семи 
оно: оно 
пустовать: пустует 
бабушка: бабушек 
раздумывать: раздумываю 
взять: возьму возьмешь взять взял 
сдача: сдачу 
образ: образом образ 
диверсифицировать: диверсифицирую 
покупать: покупать покупаем покупаю 
свое: свое 
потерять: потерять потеряю 
вполне: вполне 
соглашаться: соглашаться 
друг: друг друга другом 
складываться: сложилась сложившаяся 
ситуация: ситуацию ситуация 
каждый: каждый 
еле: еле 
сводить: сводим 
плюс: плюсов плюс 
регулярно: регулярно 
изымать: изымают 
оборот: оборота оборот 
возникать: возникали возникают возникает 
кассовый: кассовый кассового 
разрыв: разрыва разрыв 
вакансия: вакансий вакансии 
желающий: желающих 
полно: полно 
отец: отца отец 
два: две двум двух 
машина: машина машины машине машину машиной 
лада: лада 
грант: гранта 
рено: рено 
флюенс: флюенс 
безлошадный: безлошадные 
бесправный: бесправная 
каптюр: каптюр 
комплектация: комплектации 
хотеться: хотелось хочется 
предельный: предельная 
цена: ценам цены цен цена 
мочь: могут можем можешь могу могли мог 
позволять: позволяет позволить позволило 
кредит: кредитов кредиты 
выбирать: выбрал выбирал выбираем выбрали 
авто: авто 
крета: кретой 
победа: победа 
доставаться: досталась 
многое: многом 
хамство: хамства 
дилер: дилера 
общаться: общаться общаешься общаюсь общаются общаемся 
толком: толком 
попадать: попасть попадая 
решать: решать решил решаем решили решить решаю 
происходить: происходящего произошедшее происходит 
время: времена время времени 
продажа: продажи продажах продаж 
случай: случай случаи случае 
проблема: проблема проблему проблемы проблем проблеме 
плохо: плохо 
сво: сво 
убеждаться: убедился 
сторона: сторону стороны 
поменяться: поменялось 
двухкомнатный: двухкомнатную двухкомнатная двухкомнатной 
будни: будням будни 
брат: братья 
мамин: маминой 
богатеть: богатеть 
материал: материалы материал 
обо: обо 
все: всеми всем всё всему 
влиять: влияет 
ваш: ваша вашей ваши вашу 
жизнь: жизни жизнь 
почта: почта почте 
среда: средам среда 
суббота: суббота субботы субботам субботу 
бесплатно: бесплатно 
подписываться: подписаться 
регулярный: регулярные 
расход: расходов расход расходы 
продукт: продукты 
ресторан: рестораны ресторан ресторанами 
фастфудом: фастфудом 
периодически: периодически 
доставка: доставки доставку 
домой: домой 
ходить: ходить ходил ходили хожу ходим 
супермаркет: супермаркеты 
хватать: хватало хватает 
питаться: питаемся 
частично: частично 
совместно: совместно 
ездить: ездят езжу ездит ездим ездил 
тц: тц 
закупаться: закупаются 
поездка: поездку поездки поездок поездке поездках 
традиция: традиции традицией традиция 
воскресный: воскресный воскресных 
завтрак: завтрак завтраках завтраков 
вне: вне 
дома: дома 
стараться: стараюсь стараемся 
готовить: готовить готовлю 
статья: статья 
жалко: жалко 
тратить: трачу тратила тратить тратил тратите тратим 
раз: разы раза 
граница: границу границей 
неплохой: неплохим 
питер: питере 
калининград: калининграде 
москва: москве москву 
воскресение: воскресенье воскресеньям 
казань: казани казань 
выбираться: выбирались 
потратить: потратить потратили потратил 
порядок: порядка 
отпуск: отпуском отпуск отпусков отпуска 
обходиться: обошлись обхожусь обошелся 
израсходовать: израсходовал 
остальной: остальная остальные 
подарок: подарка подарки 
праздник: праздников праздник праздники 
оплачивать: оплатить оплачивают оплачивали оплаченная оплачивал оплачиваем оплатила оплачиваю оплатил оплатили оплачивать 
билет: билеты 
уходить: уходит ухожу уходить ушел уйти уйдет ушла ушло 
они: ними 
ехать: едете еду ехать едет едем 
турбаза: турбазу 
бензин: бензин 
каско: каско 
осаго: осаго 
февраль: феврале февраля 
бояться: боится боюсь 
довольный: доволен довольны 
третий: третий 
автомобиль: автомобиль автомобили 
немой: нем 
съездить: съездить съездил 
сочи: сочи 
крым: крым крыму 
смоленск: смоленск 
псков: псков 
новгород: новгород 
оренбург: оренбург 
саратов: саратов 
самара: самару 
бесчисленный: бесчисленное 
количество: количество 
аптека: аптеки 
врач: врачам 
разовый: разовые 
лекарство: лекарства 
простуда: простуды 
аллергия: аллергии 
головной: головной 
боль: боли 
спорт: спорт 
абонемент: абонемент 
клуб: клуба клуб 
прошлое: прошлом 
отдавать: отдал отдам отдает 
ремонт: ремонт ремонта 
обслуживание: обслуживание 
велосипед: велосипеда 
посещать: посещаю 
бассейн: бассейны бассейна бассейне бассейн 
категория: категории категориям категорий 
развлечение: развлечение развлечения развлечениями 
сложный: сложный 
кино: кино 
театр: театры 
стендапах: стендапах 
ниже: ниже 
посчитать: посчитает посчитать 
большой: большому большую больших большой 
набор: набор набора наборов 
подарить: подарила 
показывать: покажу показала 
коллекция: коллекцию 
красота: красота 
стричься: стрижется стригусь 
животное: животные животного животное 
шотландский: шотландская шотландскую шотландской 
вислоухий: вислоухую вислоухая 
королев: королеву 
корм: корм 
наполнитель: наполнитель 
лоток: лоток 
одежда: одежду одежды одежда 
детство: детства 
терпеть: терпеть 
идти: иду идем идет идти 
магазин: магазинов магазинам магазин магазинами магазины магазина 
вещь: вещи вещью вещь 
использовать: использую использовать 
обычно: обычно 
европа: европе 
достаточно: достаточно 
относить: отношу относить 
плавки: плавки 
хлорка: хлорки 
зимний: зимний зимние 
ботинок: ботинки ботинкам 
алкоголь: алкоголь 
мало: мало меньше 
прошлый: прошлые прошлый 
практически: практически 
пить: пью пьем пьет пить 
понравиться: понравилась понравилось 
идеал: идеале 
айсвайн: айсвайн 
гуманный: гуманным 
сам: самого сама сами самому 
ввозить: ввозить 
чемодан: чемодане 
пиво: пиво 
заведение: заведении заведениях заведение заведения 
крепкий: крепкое 
переставать: перестала перестал 
курить: курим 
сигара: сигару 
интернет: интернет 
налог: налога налог налоги 
имущественный: имущественный 
закрывать: закрыть закрыл закрывать 
убыток: убыток 
ряд: ряду ряд 
позиция: позициях позиций позиции позиция 
отбивать: отбить 
валютный: валютную 
переоценка: переоценку 
распродавать: распроданных 
иностранный: иностранных иностранным 
транспорт: транспортом транспорте транспорт 
пользоваться: пользуюсь пользоваться пользовался 
общественный: общественным 
такси: такси 
максимум: максимум 
аэропорт: аэропорт 
обратно: обратно 
никакой: никаких 
математически: математически 
оправдываться: оправдывались 
психологически: психологически 
некомфортно: некомфортно 
платинум: платинум 
сберовский: сберовская 
становиться: станет стал стать становится стало стала 
тариф: тариф 
лояльность: лояльности 
переходить: перешел 
обычный: обычной 
лимит: лимит 
плакать: плачу 
повышенный: повышенного 
дебетовый: дебетовым 
соответственно: соответственно 
сбер: сбер 
впаривать: впарил 
восемь: восемь 
назад: назад 
рамка: рамках 
зарплатный: зарплатного 
бесплатный: бесплатный бесплатной бесплатная бесплатную 
коммунальный: коммунальные 
платеж: платежи платежам 
подключать: подключили подключаем 
банк: банк банке 
подписка: подписку 
хика: хик 
инвестор: инвестора инвестор инвесторов 
превышать: превышает превысит 
нравиться: нравится 
контент: контент 
готовый: готов готова готовый готовы 
поддерживать: поддержать 
страховка: страховки 
автомобильный: автомобильных 
входить: входят 
банковский: банковский банковским 
обучение: обучение 
тренинг: тренинги 
предыдущий: предыдущие предыдущий предыдущего 
работодатель: работодатели работодателю 
план: плане планов планы планах 
поехать: поехал поеду поехать 
конференция: конференцию 
пройти: пройдет 
осень: осенью осени 
дорога: дорогу дорога дороги дороге 
благотворительность: благотворительность 
бюджет: бюджет бюджете 
свой: своей свои своими своем свой своего 
воля: воле 
подход: подход 
финансы: финансам финансами финансов 
активно: активно 
копить: копить 
начинаться: начался 
перекос: перекос 
действительно: действительно 
циферка: циферки 
таблица: таблице таблица таблицы 
оказываться: оказывались оказывается оказываются 
сердце: сердце 
легко: легче легко 
весь: вся весь 
страна: стране 
запросто: запросто 
лишаться: лишиться 
существенный: существенную существенная 
пример: пример 
блокировка: блокировки 
скачка: скачки 
валюта: валюту валют 
охотно: охотнее 
удовольствие: удовольствия 
заполнять: заполняю 
оперативный: оперативный 
приложение: приложении приложение 
finance: finance 
pm: pm 
следить: слежу 
статистика: статистика 
число: числе число 
версия: версии версия 
анализ: анализа 
просто: просто проще 
зафиксировать: зафиксировать 
просыпаться: просыпаюсь просыпается просыпаемся проснулась 
будильник: будильнику будильника будильник 
валяться: валялся валяемся валяться 
собирать: собрать собирать собираю собираем 
сегодня: сегодня 
нестандартный: нестандартный 
нагло: нагло 
воспользоваться: воспользовался 
отдыхать: отдохнуть отдыхать 
срываться: сорвались 
отсюда: отсюда 
любить: люблю любимой 
сходиться: сходилась сойдутся сошлись 
отказываться: отказалась отказался отказались 
отправляться: отправляюсь отправиться отправился 
приглашение: приглашение 
мероприятие: мероприятие мероприятия 
партнер: партнер партнеров 
гостиница: гостиница 
разбаливаться: разболелись 
перенести: перенесли 
новое: нового новое 
проверенный: проверенным 
побыть: побыть 
маршрут: маршрут маршруты 
улица: улица улицу 
бауман: баумана 
кремль: кремль 
набережная: набережная 
черный: черного черное 
озеро: озеро 
кабан: кабан 
спускать: спускаем 
парковка: парковкой парковку парковка 
загружать: загружаем 
завтракать: завтракать завтракаю 
есть: ем ела ели 
вчера: вчера 
подпортиться: подпортилось 
порция: порциям порции 
заметно: заметно 
уменьшаться: уменьшились 
октябрь: октября октябре 
мы: нам 
зависимость: зависимости 
настроение: настроения 
еда: еды еда 
вкусный: вкусная 
фреша: фрешей 
недорого: недорого 
двое: двоих 
фотографировать: фотографирую 
фигурка: фигурки 
садиться: сели сажусь садимся сяду 
путь: пути путь 
заезжать: заезжаю заехал заезжаем 
набирать: набрали набрать 
выпечка: выпечки выпечка 
утка: уткой 
татарский: татарских 
сладость: сладостей 
стартовать: стартую стартуем 
познакомиться: познакомились 
старый: старая старом старых 
начинать: начинает начали начинаю начал 
встречаться: встречаться встретимся встречаемся 
оттуда: оттуда 
подчинение: подчинении 
пусть: пусть 
прямой: прямом 
обменять: обменяет 
капризный: капризный 
принцип: принципе 
налаживать: наладили 
причем: причем 
капризничать: капризничает 
заправка: заправке 
кофе: кофе 
перекусывать: перекусываем перекусываю 
эчпочмак: эчпочмаками 
приключение: приключений 
обратный: обратном обратный 
спокойный: спокойный спокойное спокойной 
звонить: звонит звонят звоню 
ночь: ночь ночью ночи 
попытка: попытка 
вскрывать: вскрыть 
дверь: дверь 
повреждать: повредили 
входной: входную входных 
группа: группу 
минута: минут минуты 
созвон: созвон созвоны созвону 
круг: кругу 
условие: условии условиях условия 
связь: связи 
нечастый: нечастые 
розница: рознице розница розницей розницы 
норма: норма 
парковаться: паркуюсь паркуемся 
заходить: захожу заходим 
встречать: встречает встречаю встретить встречал 
радостный: радостное 
кошка: кошка кошку кошке кошки 
энтузиазм: энтузиазмом 
лезть: лезет 
тереться: тереться 
гладиться: гладиться 
видеть: вижу видел видеть 
отменный: отменный 
аппетит: аппетит 
приезжать: приезжал приезжали приезжает приезжаем приезжают приедет приехали приехал 
пятница: пятницы пятницу пятница 
утро: утра утром 
досыпать: досыпали 
корма: корма 
миска: миски 
ощутимо: ощутимо 
опустеть: опустели 
британский: британская 
красавица: красавицей красавице красавица 
ласковый: ласковая ласковее ласковой 
кись: киси 
шутить: шутим 
горожанин: горожанина 
гость: гости 
заглядывать: заглянули заглядываю заглянете 
покормить: покормить 
пушистый: пушистую 
забирать: забирать забираю заберу заберет забрать забрал забирают забрали 
дом: дому дом доме 
появляться: появляться появилась появился 
бывший: бывшим бывшего 
муж: мужем мужа 
интересный: интересное интересного интересный 
новогодний: новогодние новогоднего 
пробыть: пробыли 
намного: намного 
точить: точит 
скука: скуки 
чай: чаю чаем чай 
диван: диване 
гладить: глажу гладим 
кися: кисю 
пойти: пошел пошла пойти пойдем пошли пойдут 
парк: парка парк парке 
покататься: покатаемся покататься 
ватрушка: ватрушкой ватрушках ватрушке 
отвозить: отвез 
вернуться: вернуться вернулся вернутся 
поставлять: поставил поставлять поставили поставить 
возле: возле 
пешком: пешком 
посыпаться: посыпались 
сообщение: сообщение сообщения 
отчет: отчет отчеты отчетами 
выручка: выручки 
понедельник: понедельник 
вторник: вторникам вторник 
картина: картина 
радовать: радуют радует 
лететь: летит 
ждать: ждать ждем ждали ждет ждут жду ждете 
неприятный: неприятные 
беседа: беседы 
решение: решениях решения решение 
конечный: конечном 
прибыль: прибыль 
единственный: единственный 
показатель: показатель 
спад: спад 
перспектива: перспективы 
шевелить: шевелить 
подчиненный: подчиненных 
задача: задачам задач 
контролировать: контролирую 
закупка: закупок закупки 
оплата: оплаты оплату оплатой 
согласовывать: согласовать согласовываю согласовывать 
подразделение: подразделениям 
любой: любой любые 
процесс: процессами процессе процессах 
отвечать: отвечать отвечаю отвечает ответить 
комментировать: комментирую 
хвалить: хвалим 
ругать: ругаем 
параллельно: параллельно 
листать: листаю 
читать: читал читаю читать 
чат: чат чате чаты чатах 
подписывать: подписали подписан подписать 
market: market 
twits: twits 
forever: forever 
канал: канал каналы 
новость: новости новость новостей 
сайт: сайте сайтом 
рбк: рбк 
февральский: февральских 
событие: события событий 
усталость: усталость 
сначала: сначала 
причина: причинам причин 
поздно: позже поздно 
осознание: осознание 
ошибка: ошибки ошибка 
минимум: минимум 
планирование: планировании 
желание: желания желание желанием 
применять: применить 
навык: навыки 
уметь: умею 
управлять: управлять управлял управляющий 
россия: россии 
нужный: нужный нужен нужнее нужна нужны нужное 
недостаточно: недостаточно 
взгляд: взгляды взглядов 
обсуждать: обсудили обсуждал обсудить обсуждают обсуждаю обсуждаем 
рабочий: рабочие рабочее рабочих рабочий 
пресекать: пресекаю 
разговор: разговоры 
иметь: имеет имеют иметь 
труд: труду труда 
родной: родными 
ссориться: ссорился 
почувствовать: почувствовал 
рост: росте рост 
весна: весной 
начало: начале 
поменять: поменять 
слишком: слишком 
дорого: дорого 
повышаться: повысились 
вырастать: выросли 
успевать: успеет успел 
падение: падении 
делать: делаю делать делает делал 
опускаться: опустился опускался 
снова: снова 
касаться: касается 
отдельный: отдельных отдельный 
американский: американских 
fxcn: fxcn 
бпиф: бпиф 
равно: равно 
рассматривать: рассматривать 
сценарий: сценарии сценарий 
подобный: подобного 
непонятно: непонятно 
успокаиваться: успокоится 
надеяться: надеяться надеюсь 
половина: половиной половину 
миллион: миллиона миллион 
превращаться: превратятся 
возможность: возможность 
приближаться: приблизиться 
внешний: внешних внешнего 
пополнение: пополнений 
куча: куча 
вариант: вариантов вариант варианты 
девать: деть 
возрастать: возросшая 
неопределенность: неопределенность 
подталкивать: подтолкнула 
радоваться: радоваться 
гулять: гуляю гуляем гулять 
очередь: очередь очереди 
кататься: катаемся катается 
горка: горки 
вечер: вечером вечер вечерам вечера 
особенно: особенно 
лето: летом 
относиться: относится относишься 
ко: ко 
аттракцион: аттракционы 
остановка: остановке остановку остановки 
автобус: автобуса 
пробежаться: пробежаться 
ужинать: ужинаю ужинать 
бутерброд: бутерброды бутербродами 
предлагать: предлагает предлагали предложил предложили предлагают 
рыба: рыбу 
вдохновлять: вдохновляет 
филиал: филиалом 
возвращение: возвращения 
особый: особых особого 
разногласие: разногласий 
удаленка: удаленки удаленка 
провожать: проводил 
рано: раньше рано 
возвращаться: возвращаемся возвращаться возвращался возвращаюсь 
включать: включаю включил включаем 
запланировать: запланировать 
выгружать: выгрузить 
утренний: утренние утреннему 
посмотреть: посмотреть посмотрим посмотрели 
выключать: выключаю 
компьютер: компьютере компьютер 
тима: тима 
мартынов: мартынова 
спать: спать спит спят 
ук: ук 
переписываться: переписываюсь переписываемся 
fire: fire 
ложиться: лег ложусь лечь ложимся 
засекать: засекал 
стандартный: стандартный 
помнить: помнит помню 
почему: почему 
подъем: подъем 
желать: желаю 
добрый: добрая доброго 
процедура: процедуры 
сумка: сумку 
туда: туда 
весить: весил 
кг: кг 
минимальный: минимальный 
отдых: отдых 
новый: новой новых новый новом 
свадьба: свадьба 
родственник: родственники родственников 
заедать: заесть 
дело: делами дела деле дело 
течение: течение течению 
ноябрь: ноябре 
держаться: держится 
уровень: уровне 
весы: весах весы 
вставать: встаю вставать вставал 
страшно: страшно 
тренировка: тренировки тренировками 
тяжело: тяжелее тяжело 
заниматься: заниматься занимаюсь заняться 
темп: темпа 
открываться: откроется 
спортклуб: спортклуба спортклуб 
три: трем трех 
удобно: удобно 
располагать: расположен 
действующий: действующий 
стоять: стоят стоит 
собираться: собираемся собрался собираюсь 
осиливать: осилил 
заплыв: заплыв 
дистанция: дистанции 
км: км 
зала: зала 
тренажер: тренажеры 
смс: смс 
склад: склада склад складе 
разбивать: разбили 
серия: серии 
бывать: бывает бываем 
пропадать: пропадают 
разгребать: разгребать разгребаю 
далекий: далеки 
операционка: операционки 
погружать: погружен 
июль: июля 
находиться: находится 
турция: турции 
наливать: наливаю налил 
планшет: планшете планшет 
творог: творог творогом 
фрукт: фрукты фруктами 
банан: бананом бананы банан 
виноград: виноград 
однажды: однажды 
отель: отеле 
подавать: подали 
почитать: почту почитать 
текучка: текучку текучке текучка текучкой 
команда: командой 
менеджер: менеджер менеджеры менеджером 
офис: офисе офис офиса 
непосредственно: непосредственно 
кратко: кратко 
подкорректировать: подкорректировать 
стоимость: стоимость стоимости 
итоговый: итоговые 
зависеть: зависят 
конкурент: конкурентов 
мониторить: мониторим 
дефицит: дефицита 
скорость: скорость скорости 
насколько: насколько 
привозить: привезти привезли 
заявка: заявки 
платежный: платежный 
база: базе базы 
переводить: перевожу переводить 
срок: срок 
закрываться: закрыться 
торговаться: торгуемся 
поставщик: поставщиков поставщик поставщиками поставщику поставщика поставщиком 
арендодатель: арендодателями 
перечислять: перечислить 
срочно: срочно 
далее: далее 
задерживать: задерживать 
территория: территории 
собрание: собрание собрания 
служба: службами служба 
четверг: четверг 
официально: официально 
руководитель: руководителя руководителей 
параллельный: параллельные 
рулить: рулят 
назваться: назваться 
генеральный: генеральным 
юридический: юридические 
риск: риска риски 
название: названии 
непринципиально: непринципиально 
свобода: свобода 
принимать: принимать принимают принять принимаю 
исключение: исключением 
лишь: лишь 
увольнять: уволить 
бесполезный: бесполезной бесполезных 
кадр: кадров кадр 
давно: давно 
смиряться: смирился 
добиваться: добился добиться 
аутсорс: аутсорс 
функция: функция функций 
выполнять: выполнять 
персонал: персонал 
знакомый: знакомых знакомые 
заслуживать: заслуженные 
образование: образованию 
экономист: экономист 
университет: университете 
продавец: продавцом продавец продавца 
область: области 
постепенно: постепенно 
проходить: проходят прошла прошел пройти проходит проходишь 
торговля: торговли 
высоко: выше 
твой: твоя 
меньший: меньшее меньшую 
значение: значение 
надолго: надолго 
писать: пишут пишу пишет писали 
финдира: финдиру финдира 
кыстыбыями: кыстыбыями 
манговый: манговые 
кубик: кубиками кубики 
пытаться: пытаюсь 
обманывать: обмануть 
конфета: конфеты 
завтра: завтра 
документ: документы 
порешать: порешать 
мелкий: мелкими мелких мелкое мелкие 
например: например 
трактор: трактора 
убирать: уберет убрать 
снег: снег 
заодно: заодно 
загонять: загоняю 
мойка: мойку 
сосед: соседей соседи 
трасса: трассы 
соль: соли 
салон: салон 
мыть: мыл 
комплекс: комплекс 
чистый: чистая 
быстро: быстро быстрее 
припарковаться: припарковался 
свободный: свободный 
график: график 
мучиться: мучаюсь 
полтора: полтора 
находить: нахожу нашел находит 
ответ: ответ 
тяжелый: тяжелому 
возврат: возвратом 
покупатель: покупатели покупателя покупатель 
теория: теории 
тянуться: тянется 
стрясать: стряс 
никак: никак 
ругаться: ругаться ругаемся 
тридцать: тридцать 
компромисс: компромиссу 
доверие: доверия 
просить: просят прошу просит 
продолжать: продолжаем продолжай продолжаю 
проверять: проверять проверяю 
остаток: остатки остатками 
наценка: наценку наценки 
реализовать: реализованным 
сразу: сразу 
закидывать: закидываю 
инвесткопилка: инвесткопилку 
учитываться: учитываются 
хватить: хватило хватит 
полностью: полностью 
будапешт: будапешт 
эх: эх 
прогуливаться: прогуляться 
повод: поводу 
конфликтный: конфликтного 
недостаток: недостатки 
предъявлять: предъявили 
приобретение: приобретения 
чей: чья 
вино: вина 
невозможно: невозможно 
вывод: выводу 
обращаться: обратиться 
претензия: претензией 
юрист: юристу юристам 
прикладывать: приложит 
обоснование: обосновании 
постоянный: постоянные 
звонок: звонков звонки 
конфликт: конфликты 
стимулировать: стимулируют 
поискать: поискать 
клиент: клиентами 
доставать: достал достали 
личный: личный личными личную 
номер: номер 
выносить: выносил 
мозг: мозг 
целый: целый 
час: часа час 
берег: берегу 
море: моря 
именно: именно 
жаловаться: жаловался 
нахамить: нахамили 
единичный: единичный 
разговаривать: разговариваем 
рассказывать: рассказать расскажу рассказывает расскажите 
сервисный: сервисной 
хачапури: хачапури 
пхать: пхали 
благодарить: благодарю 
баловать: балуем 
радость: радостями 
заказ: заказы заказ заказа заказе 
извинение: извинения 
самовывоз: самовывозом 
выгодно: выгоднее 
списывать: списать 
балл: баллы 
косячить: косячат 
признавать: признают 
комплимент: комплименты 
приятно: приятно 
скидывать: скидываю 
какой: какие каких 
посылать: посылать 
ежевечерний: ежевечернее 
нормально: нормально 
расставлять: расставлять 
приоритет: приоритеты 
главное: главное 
водитель: водителям 
накапать: накапали 
суточный: суточные 
прочий: прочие 
выплата: выплат выплаты выплату 
интересовать: интересует 
сюда: сюда 
понаблюдать: понаблюдал 
схема: схему 
заставлять: заставляю заставил 
я: мной 
взамен: взамен 
попутно: попутно 
съедать: съедаю 
бананов: бананов 
сидеть: сижу сидит сидели сидеть сидят 
мать: мать 
телевизор: телевизору телевизор 
вечерний: вечерний вечернего вечерние 
перекус: перекуса перекус 
девятый: девятый 
пакет: пакет пакеты 
двадцать: двадцать 
растягивать: растягивай 
кидать: кидаю 
фото: фото 
этап: этапы этапами 
сборка: сборки 
документалка: документалку 
немецкий: немецком немецкий 
автопром: автопром 
вырубать: вырубает 
впервые: впервые 
взвешиваться: взвешиваюсь 
расстраивать: расстроенный расстроен 
жесткий: жесткому 
контроль: контролю 
питание: питанием 
зал: зал 
долгий: долгого 
перерыв: перерыва 
проплывать: проплыл проплыть 
потренироваться: потренировался 
выпивать: выпиваем выпил 
кофемашина: кофемашина 
капсульный: капсульные 
парадокс: парадокс 
выезжать: выезжаю выезжал 
особенность: особенности 
пробка: пробкам пробок 
доезжать: доехал 
получаться: получается получилось получиться 
мороз: мороз 
свободно: свободнее 
недельный: недельная 
планерка: планерка 
присутствовать: присутствуют 
отдел: отделы отдела 
рекламация: рекламации 
бухгалтерия: бухгалтерия бухгалтерией бухгалтерию 
ита: ит 
больший: большая 
прогноз: прогноз 
тащить: тащит 
заканчивать: закончил заканчиваем закончили 
прерываться: прерываюсь 
общение: общении 
дешево: дешево 
выбор: выбор 
забивать: забить 
экономия: экономии экономию 
порадоваться: порадоваться 
лишний: лишнее лишние 
вкладывать: вложить 
условный: условный условного 
втроем: втроем 
финансист: финансистом 
утверждать: утвердить 
выплачивать: выплачивать выплатить 
отличный: отличная 
минус: минусе 
устанавливать: устанавливаю 
дата: дату 
разрешать: разрешить 
технически: технически 
овердрафт: овердрафт 
построить: построен 
расслабляться: расслабились расслабляться 
многий: многих 
белый: белой 
данность: данность 
официальный: официальная официальный 
мрот: мрот 
этот: эта 
система: система 
реальный: реального реальное реальные 
максимально: максимально 
фот: фот 
кусочек: кусочком 
манго: манго 
прикол: прикол 
включая: включая 
размер: размера 
выдавать: выдают 
интрига: интриги 
танец: танцы 
бубен: бубном 
ладно: ладно 
желтый: желтый 
банкомат: банкомат 
полагать: положил 
голодный: голодный 
злой: злой 
доедать: доедаю доедаем 
соблазнять: соблазняют 
борщ: борща борщ борщом 
сало: сало салом 
встреча: встречу встрече 
идея: идеи 
ассортимент: ассортименту 
раскидывать: раскидывать раскидываю 
докинуть: докинуть 
биржа: биржу 
наличный: наличные 
распределять: распределять 
определяться: определюсь определяется 
вспоминать: вспоминаю 
растрепываться: растрепался 
чехол: чехол 
трубочка: трубочку 
сгущенка: сгущенкой 
проходиться: пройтись прошлись 
американо: американо 
зайти: зайдем зашло зашли 
поровну: поровну 
волноваться: волновалась 
щепетильный: щепетильна 
важно: важно 
состояние: состоянии состояние 
обеспечивать: обеспечить 
дарить: дарим 
прогулка: прогулка прогулке 
складской: складской складские 
логистика: логистику логистики 
пора: пор пора 
скоро: скоро скорее 
вытаскивать: вытащить 
больно: больно 
заранее: заранее 
мелочь: мелочь 
полистать: полистать 
новинка: новинок новинки 
монетизация: монетизацию 
приглядывать: приглядел 
представлять: представляю 
лист: листом 
весть: вести 
переговоры: переговоры 
жаба: жабой 
награда: награду 
достигнутый: достигнутые 
домик: домик 
ночной: ночной 
дожора: дожор 
сладкий: сладкое сладкий сладким 
душа: душа 
засыпать: засыпаем засыпать 
строить: строим 
перемещение: перемещений 
будний: будний 
одинаково: одинаково 
тренажерный: тренажерного тренажерный 
помирать: помер 
подниматься: подняться 
переодеваться: переодеваюсь 
плавать: плаваю 
болеть: болели 
рука: руки руках 
удивление: удивление 
сауна: сауны сауне 
никто: никого никому никто 
поваляться: повалялся 
занятие: занятий 
уснуть: уснул уснуть 
морозец: морозцу 
взбадриваться: взбодриться 
комплаенс: комплаенс 
interactive: interactive 
brokers: brokers 
конь: конь 
вставлять: вставляю 
халатность: халатность 
перефразировать: перефразирую 
фильм: фильма фильмов фильм 
фактически: фактически 
исполнять: исполнили 
критично: критично 
человек: человека людьми людей человеку человек 
проконтролировать: проконтролировать 
исполнение: исполнение 
нести: нести 
ответственность: ответственность 
важный: важнее важный 
тщательный: тщательного 
просчет: просчета 
допиливать: допиливать 
директорский: директорских 
усугубляться: усугубляется 
речь: речь 
скорректировать: скорректировать 
проанализировать: проанализировать 
завершаться: завершатся 
единогласно: единогласно 
апрель: апрель 
приучать: приучили 
моментально: моментально 
вовремя: вовремя 
откатывать: откатывать 
ошибаться: ошиблись 
сравнение: сравнению 
нормальный: нормальных нормальными нормальный 
правильно: правильно 
большинство: большинство 
повышать: повышало 
ради: ради 
сметный: сметной 
нажива: наживы 
почем: почем 
следующий: следующий 
смысл: смысла смысле смысл 
перезапускать: перезапустить 
сохранять: сохранить 
регулировать: регулируя 
поесть: поесть поели 
предстоять: предстоят предстоит предстоящий 
разъезд: разъезды 
везде: везде 
описывать: описывать описывали 
специфика: специфика 
уставать: устал устаю 
искренне: искренне 
завидовать: завидую 
бухгалтер: бухгалтерам бухгалтера 
возмущаться: возмущаются 
заканчиваться: закончился 
точка: точки точке 
ceo: ceo 
млрд: млрд 
сложно: сложно 
голова: голова голове 
целиком: целиком 
следствие: следствие 
выживаемость: выживаемостью 
объем: объем 
никуда: никуда 
веселый: веселое 
выматывать: выматывающее 
бар: бар 
пекарня: пекарню пекарне 
советовать: советую 
ввязываться: ввязывается 
гореть: горят гори 
предпочитать: предпочитая 
управленческий: управленческие 
найм: найме 
помещение: помещение помещении 
близко: поближе 
расположение: расположение 
устраивать: устраивает устроили 
удаленке: удаленке 
возражать: возражаю 
многие: многие 
недовольный: недовольны 
ремонтировать: ремонтировать 
учредитель: учредители 
королева: королеве королевой королева 
доливать: доливаю 
вода: воды воду водой 
насыпать: насыпаю 
урчать: урчит 
навещать: навестил 
себя: собой 
совершенно: совершенно 
оба: обоим 
выступать: выступать 
модератор: модераторами 
слушать: слушаю 
перепалка: перепалку 
прерывать: прерывать 
бесполезно: бесполезно 
вмешиваться: вмешиваться 
поглаживать: поглаживаю 
успокаивающе: успокаивающе 
запарковываться: запарковался 
корить: корю 
слабость: слабость 
вязанка: вязанку 
пирожок: пирожок пирожки пирожка 
картошка: картошку картошкой картошки 
заливать: заливаю залили 
вчерашний: вчерашней вчерашнюю вчерашние вчерашний вчерашнего 
яйцо: яйцами яйцом 
обедать: обедают обедаю 
видимо: видимо 
полезно: полезнее 
присылать: прислал 
товарный: товарную 
матрица: матрицу 
ценовый: ценовым 
сегмент: сегментам 
требовать: требовали 
созваниваться: созваниваемся созванивался 
ловить: ловить 
подъезд: подъезде 
уронить: уронил 
стекло: стекло 
неудачно: неудачно 
треснуть: треснуло 
защитный: защитное 
побивать: побитым 
упасть: упал 
плитка: плитку 
скол: скол 
угол: угол углу 
мешать: мешал мешает 
последствие: последствия 
школа: школе 
секция: секция секции 
поймать: поймать 
догоняться: догоняюсь 
сыр: сыром сыр 
чашка: чашке чашка 
интервью: интервью 
евгений: евгением 
коган: коганом 
маркетплейс: маркетплейс 
зеленый: зеленого 
банка: банка 
застежка: застежкой 
зиплока: зиплок 
разбирать: разберу разобрать 
запечатывать: запечатанных 
деревня: деревню 
хогсмид: хогсмид 
кузница: кузница 
открыто: открыто 
мотив: мотивам 
гарри: гарри 
поттер: поттере 
залезать: залез 
обзор: обзоры 
z: z 
fold: fold 
странный: странный странная 
самсунг: самсунги 
нынешний: нынешний 
мейза: мейзу 
флагман: флагманами 
сей: сей 
агрегат: агрегат 
даром: даром 
рождение: рождения 
сообщать: сообщить сообщает 
багет: багета 
сходить: сходить 
благо: благо 
поблизости: поблизости 
апельсин: апельсины 
йогурт: йогуртам йогуртов йогуртом 
невесть: невесть 
откуда: откуда 
взяться: взявшимися 
конфетка: конфетками 
душ: душ 
угрызение: угрызениями 
совесть: совести 
прямо: прямо 
вырубаться: вырубился 
покупка: покупки покупку 
пятый: пятый 
сурок: сурка 
список: список 
пропустить: пропущенных 
перезванивать: перезваниваю 
выяснять: выясняем выясняю выяснил 
неожиданно: неожиданно 
насмарку: насмарку 
перекраивать: перекроили 
обещать: обещали обещанного 
положенный: положено 
поступать: поступлю 
хотелка: хотелки 
традиционный: традиционный 
капитализация: капитализации 
совещание: совещание 
командировка: командировке 
спешить: спешить 
пообщаться: пообщались 
неинтересный: неинтересны 
плохой: плохой плохим 
бэкграунд: бэкграунд 
просрачивать: просрачиваем 
холодно: холодно 
палец: пальцы пальцем 
мерзнуть: мерзнут 
залипать: залипал залип 
герой: герой героев 
пролистывать: пролистать 
судя: судя 
весело: весело 
коварно: коварно 
мимо: мимо 
плевать: плевать 
наггетс: наггетсы 
смог: смог 
соседний: соседнем соседний 
постамат: постамата 
сгорать: сгорел 
сарай: сарай 
хата: хата 
сверху: сверху 
орешек: орешками 
достаточный: достаточная достаточной 
физический: физической 
активность: активности 
терять: теряю 
бич: бич 
кухня: кухни 
цеплять: цепляешь 
промзона: промзоне 
обед: обед 
негде: негде 
перечитывать: перечитываю 
совет: совет 
начислять: начислено 
говориться: говорится 
ожидаться: ожидалось 
конкретно: конкретно 
аудиокнига: аудиокниги 
кпк: кпк 
palm: palm 
аудио: аудио 
книга: книги 
бушкова: бушкова 
аудиоверсия: аудиоверсии 
насмотреться: насмотрелся 
овчарка: овчарка 
стрелять: стреляла 
винтовка: винтовки 
ребенок: дети детей ребенок ребенком 
новшество: новшества 
объединение: объединения 
пфр: пфр 
фсс: фсс 
бардак: бардак 
гпх: гпх 
лазейка: лазейку 
малый: малого 
убивать: убили 
трамвай: трамвай трамвае 
довезти: довезет 
проезд: проезд 
попадаться: попался 
крайне: крайне 
редко: редко 
прикольно: прикольно 
подряд: подряд 
терминал: терминал 
крещение: крещение 
бокал: бокалу 
равнодушный: равнодушен 
церковный: церковным 
торжество: торжествам 
верующий: верующая 
отмечать: отмечаем 
обязательно: обязательно 
воскресать: воскрес 
ужин: ужин 
прийти: придет 
разбираться: разбираться 
пожалеть: пожалею 
ставить: ставлю 
напоминание: напоминание 
стрим: стримы стрим 
перестраивать: перестраиваю 
стол: столе 
досматривать: досмотрю 
запись: записи 
господи: господи 
спасибо: спасибо 
шестой: шестой 
поиграть: поиграть 
запускать: запускаю 
игрушка: игрушку 
греться: греться 
поставка: поставки 
поздороваться: поздоровался 
поговорить: поговорил 
оператор: операторам оператор 
грузить: грузят 
кабинет: кабинет 
сочник: сочник 
переливать: перелил 
кружка: кружку 
вацлавская: вацлавской 
площадь: площади 
прага: прагу 
проблемный: проблемным 
затрата: затратах 
чугунный: чугунная 
рассчитывать: рассчитывал 
поругаться: поругался 
управляющий: управляющим 
плыть: плыло плывет 
пятнадцать: пятнадцать 
проветриваться: проветриться 
догнаться: догнался 
вареный: вареными 
очередной: очередным 
маленький: маленьким маленький 
позвонить: позвонила 
попросить: попросила 
оформлять: оформить оформляю 
мясо: мясо 
молочка: молочку молочки 
обсуждение: обсуждение обсуждения 
тупик: тупик 
тип: типа 
шесть: шесть 
взаимодействовать: взаимодействовал 
напрямую: напрямую 
сталкиваться: сталкиваюсь 
несоблюдение: несоблюдением 
устный: устный 
договор: договор договору 
гораздо: гораздо 
весомый: весомее 
служебный: служебной 
записка: записки 
письменный: письменный 
полагаться: полагающийся полагался 
спустя: спустя 
заплатить: заплатили 
заявление: заявлением 
передавать: передавать 
прибавка: прибавку 
оффер: оффере 
нарекание: нареканий 
затык: затык 
переоформлять: переоформить 
прогреваться: прогреваться 
пятилитровый: пятилитровую 
бутылка: бутылку 
пятничный: пятничным 
рейс: рейсах 
ноутбук: ноутбука ноутбуке ноутбуку 
шашлык: шашлык 
картофель: картофель 
фри: фри 
стелить: стелем 
кровать: кровать 
гирлянда: гирлянду 
елочка: елочке 
зажигать: зажигаем 
свечка: свечки 
седьмой: седьмой 
уютно: уютно 
посапывать: посапывает 
рядом: рядом 
нога: ногах 
мысль: мысль 
лыжа: лыжах 
погуглить: погуглил 
соревнование: соревнования 
светить: светит 
пицца: пицца пиццу 
попить: попили 
духовка: духовку 
литр: литров 
дегустировать: дегустировать 
отлично: отлично 
значит: значит 
погулять: погуляешь 
скучно: скучно 
ныть: ныть 
пылесос: пылесос пылесоса 
пугаться: пугается 
комната: комнаты комнате 
убегать: убегает 
дальний: дальний 
изучать: изучив изучаю 
пороховой: пороховой 
бочка: бочке 
звать: звали 
факт: факту 
положение: положение 
переживать: переживать пережили 
выводить: вывели 
запас: запас запаса 
прочность: прочности 
глупо: глупо 
поиск: поиске поиски 
спокойно: спокойно спокойнее 
безделье: безделья безделье 
искать: искал 
чувство: чувством 
утомлять: утомляет 
проедаться: проедаться 
потеря: потеря 
волновать: волновать 
финансовый: финансовой 
зрение: зрения 
сериал: сериал 
тюлений: тюленьих 
совпадать: совпало 
предаваться: предаемся 
ничегонеделание: ничегонеделанью 
попрыгать: попрыгать 
площадка: площадки площадку 
поужинать: поужинаем 
пирожное: пирожные 
страшный: страшные 
сладкоежка: сладкоежки 
держать: держать 
нереально: нереально 
бокс: бокс 
локер: локером 
кстати: кстати 
дважды: дважды 
несостоявшийся: несостоявшееся 
берет: берет 
ролл: роллы 
лапша: лапшу 
дамплинг: дамплинги 
сок: сок 
капучино: капучино 
вкусно: вкусно 
объятие: объятиях 
урчалка: урчалка 
тихо: тихо 
платный: платная 
авторский: авторская 
рассылка: рассылка 
сбережение: сбережения 
ясный: ясный 
ум: ум 
указывать: укажите 
предпочтение: предпочтения 
читатель: читатели 
делиться: делятся 
тэг: тэги 
обложка: обложке 
ксения: ксения 
михайлов: михайлова 
сэкономить: сэкономили 
комментарий: комментарии 
модерация: модерацию 
журнал: журнала 
печенька: печенька 
блин: блин 
чувак: чувак 
разменивать: разменяет разменяете разменяла 
вечность: вечность 
настолько: настолько 
заботиться: заботишься 
доверять: доверяешь 
винсент: винсент 
ell: ell 
мема: мемы 
кот: кота кот 
уверять: уверены 
спрашивать: спрашиваете 
попробовать: попробовать 
повторять: повторить 
образовываться: образовался 
мемный: мемный 
вакуум: вакуум 
уход: уход ухода 
скрывать: скрывать 
вооружение: вооружение 
стиль: стиль 
дженерик: дженериком 
он: нему 
против: против 
fz: fz 
филлипыч: филлипыч 
коллективный: коллективным 
разум: разумом 
янус: янус 
полуэктович: полуэктович 
стругацкий: стругацких 
яркий: ярком яркий 
пошлый: попошлее 
определеный: определеный 
стажироваться: стажируется 
соответствовать: соответствовать 
вводить: ввели 
персонаж: персонажей 
легенда: легенда легенду 
архив: архив 
редакция: редакции 
riddler: riddler 
oh: oh 
boy: boy 
натуральный: натуральная 
конспирология: конспирология 
творить: творить 
абсолютно: абсолютно 
суть: суть сути 
предельно: предельно 
плотно: плотно 
предварительно: предварительно 
прилично: прилично 
подымать: поднимал 
рейтинг: рейтинг 
user: user 
деваться: делся 
сашенька: сашенька 
hi: hi 
крутиться: крутимся 
одуван: одуван 
филиппыч: филиппыч 
таки: таки 
однообразно: однообразно 
ровно: ровно 
alansor: alansor 
pentagrammaton: pentagrammaton 
объявлять: объявим 
инвестировать: инвестировать 
предприятие: предприятие 
полмешка: полмешка 
izmelochei: izmelochei 
отставка: отставку 
темич: темич 
супергерой: супергерой 
фотопруф: фотопруф 
сравнивать: сравним 
pavla: pavla 
tolokonina: tolokonina 
данные: данные 
устаревать: устарели 
ева: ева 
ц: ц 
киану: киану 
еще: ещё 
котик: котик 
ахи: ахах 
волос: волос 
юный: юном 
солнце: солнце 
затмевать: затмить 
сияние: сиянием 
лысина: лысины 
skate: skate 
middleton: middleton 
ухо: ушами 
честь: честь 
ван: ван 
гог: гога 
ник: ник 
инф: инфа 
фоторобот: фоторобота 
биться: бился 
тайсон: тайсоном 
крутой: крутой 
лего: лего 
мария: мария 
сакаев: сакаева 
согласный: согласна 
студент: студенты студент 
взрослый: взрослее взрослого 
мальчик: мальчики 
исход: исходе 
десяток: десятка 
воровать: ворующие воровать 
молодость: молодость 
женщина: женщине женщина женщин 
уверенный: уверенные 
вечно: вечно 
молодой: молодой 
пожелать: пожелать 
поумнеть: поумнеть 
бросать: бросать брошенное 
вор: вора 
старость: старости 
чужой: чужое 
женский: женское 
arinchik: arinchik 
патология: патология 
отредактировать: отредактировано 
пол: пол 
короткий: коротких 
близость: близости 
хозяин: хозяевами 
ход: ход 
кошачий: кошачья 
месть: месть 
газлайтер: газлайтер 
объяснять: объясните 
коммуналка: коммуналку коммуналки 
отклеиваться: отклеивающимся 
обои: обоям 
спокойненький: спокойненько 
мнение: мнение 
крыша: крышей 
великовозрастный: великовозрастными 
детина: детинами 
неужели: неужели 
собственный: собственный 
ребеночек: детки 
наглый: наглые 
светлана: светлана 
дмитриев: дмитриева 
грязный: грязной 
тысяча: тысяч 
зато: зато 
доходить: дойдут 
собственно: собственно 
понятно: понятно 
средство: средства 
куркуль: куркуль 
ку: ку 
шея: шее 
ожидание: ожидании 
ivan: ivan 
petrov: petrov 
добавлять: добавить 
убавлять: убавить 
ромовый: ромовый 
кейкпопс: кейкпопс 
дмитрий: дмитрий 
никонов: никонов 
шиза: шиза 
nyash: nyash 
myash: myash 
уважаемый: уважаемая 
непрошенный: непрошенный 
бежать: бегите 
вы: вами 
ударять: ударил 
организовывать: организовать 
совместный: совместное 
проживание: проживание 
звоночек: звоночек 
интересно: интересно 
кубышка: кубышку 
здорово: здорово 
классно: классно 
адекватный: адекватной 
прощение: прощения 
токсичность: токсичность 
эмоция: эмоции 
вызывать: вызываете 
циник: циник 
прочитывать: прочитал 
вводный: вводную 
массандра: массандру 
кайф: кайф 
изменяться: изменится изменилась 
экономный: экономный 
терапия: терапия 
ты: тебе 
родительский: родительских 
молодец: молодец 
дух: духе 
venividivici: venividivici 
актив: активам 
существовать: существуют 
помогать: помогаете 
katherine: katherine 
контур: контур 
прокаженная: прокаженная 
creep: creep 
бессмысленный: бессмысленный 
беспощадный: беспощадный 
ганнибал: ганнибал 
электер: электер 
логично: логично 
логика: логика 
прекрасный: прекрасный 
грех: грех 
обращать: обратить 
внимание: внимание 
любовь: любовь 
поступок: поступки 
нежели: нежели 
гипотеза: гипотеза 
одинокий: одинокая одинокой 
кормить: кормить 
голодать: голодала 
прикрывать: прикрыть 
царица: царицей 
владычица: владычицей 
морской: морской 
прощать: прости 
гспди: гспди 
тема: теме 
декрет: декрете 
аланья: аланьей 
дежурный: дежурный 
электромонтер: электромонтер 
новосибирск: новосибирске 
бали: бали 
ереван: ереване 
владелец: владелец 
пвз: пвз 
установка: установки 
нефтяной: нефтяной 
уфа: уфе 
безработный: безработный 
студентка: студентка 
биоинформатика: биоинформатик 
киль: киле 
репетитор: репетитора репетитор 
русский: русскому 
язык: языку 
белград: белграде 
фрилансер: фрилансер 
кемерово: кемерове 
реклама: рекламе 
подмосковье: подмосковье 
инженер: инженер 
приволжский: приволжском 
федеральный: федеральном 
округ: округе 
преподаватель: преподаватель 
колледж: колледжа 
красноярск: красноярске 
мошенник: мошенникам 
понадобиться: понадобились 
справка: справки 
каникулы: каникулы 
инвалидность: инвалидностью 
уведомлять: уведомлять 
белоруссия: белоруссии 
работник: работник 
ипать: ип 
сотрудничать: сотрудничают 
дверной: дверную 
ручка: ручку 
замок: замок 
клей: клеем 
протест: протест 
завещание: завещание 
здание: здание 
баланс: баланс 
багаж: багажом 
косметичка: косметичка 
чувствительный: чувствительной 
комбинированный: комбинированной 
кожа: кожей 
акна: акне 
вернуть: вернуть 
отрабатывать: отработала 
целевой: целевому 
популярный: популярное 
посылка: посылка 
застревать: застряла 
таможня: таможне 
стаут: стауты 
гоза: гозе 
ламбик: ламбики 
крафтовый: крафтовое 
въезд: въезда 
сербия: сербию 
россиянин: россиян 
поколение: поколение 
девяностый: девяностых 
беспроводный: беспроводные 
колонка: колонки 
удачный: удачных 
модель: моделей 
классный: классные 
впечатление: впечатления 
apple: apple 
watch: watch 
контакт: контакты 
политика: политика 
конфиденциальность: конфиденциальности 
пользование: пользования 
ао: ао 
лицензия: лицензия 
