жить: живу живет жить живущих живут 
дежурный: дежурный 
электромонтер: электромонтер 
новосибирск: новосибирске новосибирск 
зарплата: зарплатой зарплата зарплат 
промой: промо 
tinkoff: tinkoff 
black: black 
бесплатно: бесплатно 
полгода: полгода 
заказывать: заказали заказываю заказать заказал 
карта: карте карты карту 
учебник: учебник 
сравнятор: сравнятор 
сообщество: сообщество 
ипотека: ипотеку ипотека 
кредитный: кредитная 
история: историю история 
тест: тесты 
дневник: дневников дневник дневниках дневника дневнике дневники 
трата: траты трат трата 
налоговый: налоговая налоговые налоговую налоговый 
вычет: вычет 
написать: написать написано написан написал 
инвестиция: инвестиций инвестиции 
бизнес: бизнес бизнеса 
разбор: разборы 
закон: законов 
калькулятор: калькуляторы 
путешествие: путешествие путешествия 
медицина: медицина 
здоровье: здоровье здоровья здоровьем 
недвижимость: недвижимость 
подкаста: подкасты 
видео: видео 
смотреть: смотреть смотрите смотрим смотрю смотрит смотрел 
сервис: сервисы 
расчет: расчете расчетам расчеты 
закладка: закладки 
письмо: письма 
оставаться: осталось оставайтесь осталась остался оставшиеся остались 
деньги: деньгами деньги денег 
поток: потоки 
начало: начале начало 
январь: января 
год: год году лет года лета 
электрик: электрик электрика 
зарабатывать: заработало зарабатывает 
р: р 
профиль: профиль 
автор: автора авторам автор 
возраст: возраст 
город: города городе город 
семья: семья семьи 
родитель: родителям родители родителей родителях родителями 
частный: частном 
двухэтажный: двухэтажном 
дом: дому дом доме 
также: также 
попугай: попугаев попугая попугай 
кличка: кличке 
ворона: ворона 
мама: маме мамой мама маму 
отец: отцом 
разводиться: развелась 
отчим: отчиму отчима отчим отчимом 
сестра: сестер 
брат: братьев 
дедушка: дедушки 
бабушка: бабушки бабушке 
умирать: умерли 
должность: должность 
дэм: дэм 
работать: работает работала работаем работаю работают работать работал 
посменно: посменно 
смена: смене сменами смена смены сменой сменах смен смену 
выпадать: выпадают выпадает 
попадать: попадают попало 
стандартный: стандартной стандартная стандартный 
график: график 
два: две двум двух 
выходной: выходные выходного выходной выходных 
далеко: дальше 
ночь: ночь ночью ночи 
итого: итого 
цикл: цикл 
восемь: восемь восьми 
день: дня днем день дни дней 
новый: новые новой новый 
индустрия: индустрии 
теплоэнергетика: теплоэнергетика 
зависеть: зависит 
количество: количества 
месяц: месяца месяце месяц месяцев 
среднее: среднем 
бывать: бывает бываю бывают 
дополнительный: дополнительных дополнительные дополнительный 
рабочий: рабочего рабочих рабочем рабочие рабочий 
который: который которые которых которая которое которым 
оплачиваться: оплачиваются 
двойной: двойному двойной 
тариф: тарифу тариф 
например: например 
однажды: однажды 
получать: получите получить получаю получать получили получило получил 
забывать: забыть забыл 
выглядеть: выглядел выглядит 
премия: премий 
компенсация: компенсаций 
источник: источники источник 
доход: доходом дохода 
практически: практически 
кэшбэк: кэшбэк 
порядок: порядка порядке 
процент: проценты 
накопительный: накопительного накопительном 
счет: счете счет счета счетах 
бкс: бкс 
прошлое: прошлого прошлом 
постепенно: постепенно 
набираться: набираются 
балл: баллов баллы 
магазин: магазинам магазина магазине магазин 
мало: поменьше мало меньше 
тратить: трачу тратила тратят тратил 
выходить: выйти выходило вышел вышла выходит 
каждый: каждой каждые каждый каждого 
рубль: рубля рублю 
недавно: недавно 
тот: те тех той ту 
появляться: появляется появляюсь появляться появилась появляются появилось 
замануха: замануха 
потратить: потратили потраченные 
давать: давайте давали даю дает 
подарок: подарки подарок 
просто: просто проще 
чек: чеком чек 
приложение: приложении приложения 
оплачивать: оплачивает оплачиваю оплатить оплачиваемый 
они: ними ими 
товар: товар товары 
итог: итоге 
плюс: плюс 
халява: халяву халявы 
часто: чаще 
покупать: покупать покупал покупаю 
продукт: продуктов продукты 
именно: именно 
выставлять: выставляю 
пара: пару пара 
продавать: продавала 
старый: старый старую 
резина: резину 
машина: машина машины машине машину машин 
сколько: сколько 
откладывать: откладываю 
накоплять: накопил 
считать: считаю считают считая 
замораживать: заморожены замороженных 
лежать: лежало лежат лежит 
сбережение: сбережения 
идти: шел идет идти иду шли идут 
фондовый: фондовый 
рынок: рынок рынке 
финансовый: финансовую 
подушка: подушку 
планировать: планировал планирую планируете 
накапливать: накопить 
минимум: минимум 
около: около 
шесть: шести шесть 
месячные: месячных 
использовать: используют использовать 
быть: будут буду будем 
менять: менять 
профессия: профессии профессию 
смениться: сменились 
приоритет: приоритеты 
странный: странных 
событие: событий 
решать: решил решили 
сфера: сфере сферу 
работа: работе работу работы работа работой 
айтишный: айтишную айтишном 
это: этим это 
поскольку: поскольку 
начинать: начинаю начать начал начинает начали начала начинать 
приходиться: приходится придется пришлось 
ноль: нуле нуля 
первый: первом первые первую первое первый 
время: время времени времен 
возможно: возможно 
ехать: ехать еду едем 
право: права 
вероятно: вероятно 
часть: часть части 
уходить: уходят уходя уходит уходим ухожу ушли уйдете уйдет 
туда: туда 
желание: желания желание 
учиться: учиться учусь 
думать: думает думал думаю думаем 
понадобиться: понадобились понадобится 
основной: основной основная основное 
обучение: обучение обучения 
входить: входят вошло войти входит 
час: часа часу час часов 
инструктор: инструктором 
знать: знаем знал знаешь знать знаю знает 
потребоваться: потребуется 
занятие: занятия занятие занятий 
кроме: кроме 
примерно: примерно 
заплатить: заплатил заплачу 
медосмотр: медосмотр 
инвестировать: инвестировать 
суммарный: суммарно 
вкидывать: вкинул вкинуть 
портфель: портфеле 
актив: активы 
точный: точную 
стоимость: стоимость стоимости 
называть: называемой назвать 
сложно: сложно 
вкладывать: вкладывать вложены 
ирландский: ирландские 
китайский: китайские китайский 
американский: американские 
фонд: фонды 
акция: акций 
тикер: тикеры 
помнить: помнящих помню 
втб: втб 
иностранный: иностранным иностранные 
переводить: перевожу перевели перевел переводили 
другой: другому других другим другого другие другое другими 
брокер: брокерам 
собственность: собственность 
таковой: таковой 
ездить: ездят ездил езжу ездили 
свой: своей свои свой своя своего своим своих 
сузуки: сузуки 
лиана: лианы 
выпуск: выпуска 
точно: точно точнее 
оба: обе 
богатеть: богатеть 
главный: главная главные 
материал: материала материалы 
обо: обо 
все: всем всему 
влиять: влияет 
ваш: ваших вашего ваш вашей ваши ваше 
жизнь: жизни жизнь 
почта: почте 
среда: средам среда 
суббота: суббота субботам 
подписываться: подписаться 
регулярный: регулярных регулярной регулярные 
расход: расходов расходы 
сказать: сказал сказать сказала сказали 
категория: категории категорию 
большой: большого больших большую большие 
получаться: получается получилось получилась получился 
брать: беру брать берите брал 
мелкий: мелких 
магазинчик: магазинчиках 
накинуть: накинуть 
тысяча: тысячи 
вестись: ведусь 
всякий: всякие всяких 
красный: красные 
ценник: ценники 
особенно: особенно 
видеть: видела вижу видишь видим 
скидка: скидки скидку скидкой 
кофе: кофе 
стоять: стоит 
целое: целом 
больший: большая большей 
бюджет: бюджета бюджет 
желудок: желудок 
понятный: понятное 
дело: дела делом дело дел делами деле 
кухня: кухня 
холодильник: холодильника холодильнике холодильники холодильник 
общий: общим общие общее общий общем общего 
назад: назад 
посчитать: посчитать 
одинаково: одинаково 
периодически: периодически 
готовить: готовить готовим готовил 
есть: ест едим едят ем ел 
вместе: вместе 
столовая: столовая столовой 
обедать: обедаю 
техучеба: техучебе техучебы техучебу 
пицца: пиццу 
домой: домой 
вне: вне 
дома: дома 
учитывать: учитывая учел учитываю 
отдельно: отдельно 
вообще: вообще 
редко: редко 
транспорт: транспортом транспорте транспорт 
бар: бары бар 
подруга: подруги подруге подруга 
такси: такси 
добираться: добираюсь добраться 
рано: раньше пораньше рано 
дешево: дешево 
цена: ценах цены цена 
понижать: пониженном 
спрос: спросе 
минималка: минималка 
колебаться: колеблется 
диапазон: диапазоне 
выпрыгивать: выпрыгивает 
рамка: рамки 
дневной: дневную дневными 
утро: утрам утра утром 
обычно: обычно 
один: одном одна одного одно одну 
предприятие: предприятию предприятии предприятия предприятие 
либо: либо 
забирать: забирает забрать забрал 
коллега: коллегу коллеги коллег коллегам коллегой коллега коллегами коллеге 
соседний: соседней соседнюю 
улица: улице 
минута: минут минуты минутой 
общественный: общественном общественным 
пересадка: пересадкой 
развлечение: развлечения 
друг: другом друзьями друзьям 
раз: раза 
мочь: можем могут могло можешь могу могли могла мог 
сходить: сходил сходить 
оставлять: оставили оставить оставляю 
максимальный: максимальный 
покупка: покупка покупки покупками 
нерегулярно: нерегулярно 
февраль: февраля 
казахстанский: казахстанский 
отсылать: отсылаю 
тенге: тенге 
закидывать: закидываю 
остальной: остальные 
требовать: требует требуют 
вложение: вложений 
задрот: задрот 
основное: основном 
играть: играть играйте играл играю играли 
игрушка: игрушки игрушек 
скачать: скачанные 
мой: моем мою моего мои моей 
любимый: любимые любимых 
ведьмак: ведьмак 
серия: серия 
гта: гта 
неделя: недели неделе неделю неделя неделей недель 
пить: пью пьют пить 
пиво: пиво 
сериальчик: сериальчик 
длиться: длится 
пивной: пивное 
удовольствие: удовольствием удовольствие 
зависимость: зависимости 
закуска: закуски 
достаточно: достаточно 
охота: охота 
рыбка: рыбки 
фисташка: фисташек 
гренок: гренок 
чесночный: чесночных 
сделать: сделал сделана сделали сделанных сделать 
тепленький: тепленьких 
сауна: сауну сауны сауне сауна 
рассказывать: рассказать расскажу рассказывает расскажите 
обучаться: обучаюсь 
ментор: ментора 
бишь: бишь 
учитель: учителем учителя 
преподаватель: преподавателя преподаватель 
находить: нашла нахожу нашел найти 
чат: чате чатов 
заниматься: заняться займитесь занимаюсь занимался занимается занимаетесь занимайтесь заниматься занимаемся 
такой: такая такого таким такому такими такое такие такую 
принцип: принципу 
задание: задания заданий задании задание 
выполнять: выполняем выполнять выполняю выполнил выполняя 
непонятно: непонятно 
горячий: горячий 
стаж: стаж 
наработаться: наработается 
конец: конца конец конце 
хотеть: хотел хотели хочешь хочет хочу 
увольняться: увольняться 
бронь: бронь 
недавний: недавних недавнего 
известный: известных 
коммунальный: коммунальные 
платеж: платежи 
отдавать: отдаю 
мать: матери 
прочий: прочие 
жку: жку 
бонус: бонусы бонусом 
школа: школе школу 
уровень: уровни уровень 
узнавать: узнал узнаю узнавал 
спорт: спортом спорт 
декабрь: декабря 
записываться: записался 
качалка: качалки качалку 
ежемесячный: ежемесячных ежемесячные ежемесячный 
абонемент: абонемент 
пока: пока 
купить: купил купила купить купит 
перчатка: перчатки 
пояс: пояс 
зала: зала 
разовый: разовая 
автомобиль: автомобили 
родительский: родительские 
регулярно: регулярно 
тратиться: тратиться трачусь 
возить: возят 
бензин: бензин 
страховка: страховку страховок страховки 
плановый: плановый 
ремонт: ремонт ремонта ремонте 
раскидывать: раскидать 
подкидывать: подкидываю 
заправка: заправку 
сегодня: сегодня 
полбак: полбака 
обходиться: обошлись обойдется обошлось 
интернет: интернет 
камера: камера камеры 
наблюдение: наблюдения 
животное: животные 
собака: собаку собака собакой 
кот: кота кот 
кормить: кормят 
попуг: попугов попугу попуга попуге 
фрукт: фрукты фруктов 
яблоко: яблоко 
отрезать: отрезаю 
треть: треть 
остальное: остальное 
доедать: доедаю 
прямо: прямо 
кило: кило 
мандарин: мандаринов 
мандаринка: мандаринки 
съедать: съедала съел съедал съедят 
долька: долек дольки 
отказываться: отказывалась отказаться 
обращать: обращала обратите 
внимание: внимания внимание 
следующий: следующие следующего 
корм: корм 
средний: среднее средней средних среднего 
заводить: завести 
сова: сову 
понимать: понял поймет поняли понимаю понимать понять 
слишком: слишком 
врач: врачу врачей 
взять: возьму взял 
квалификация: квалификации 
размер: размеру 
становиться: становится стали стал стало 
нужный: нужен нужна 
очень: очень 
высокий: высшее высокая высокой высокий 
температура: температура температуры 
градус: градусов 
я: мной 
комната: комнаты комнату комната комнате 
выдерживать: выдержу 
подписка: подписки подписку подписок 
рассрочка: рассрочка 
алиса: алису 
плакать: плачу 
премиум: премиум 
красота: красота 
природа: природы 
красивый: красивее красив 
стричься: стригусь 
бриться: бреюсь 
триммер: триммером 
строй: строя 
машинка: машинка 
телефон: телефон телефону телефоне телефоны 
алтай: алтай 
снимать: снимали 
домик: домик 
организовывать: организовать 
поездка: поездка поездках поездку 
одежда: одежду одежда одеждой 
нечасто: нечасто 
поэтому: поэтому 
трусы: трусов трусы 
носок: носки носков 
последний: последнее последняя последний последние 
четверо: четверо 
пять: пять пяти 
пар: пар 
зимний: зимние 
берец: берцы 
нравиться: нравится нравятся 
зима: зимой зиму 
стоить: стоить стоящими стоили 
шапка: шапку 
тапочек: тапочки 
банковский: банковские 
случай: случай случая случаю случае 
показательный: показательны 
вещь: вещами вещи вещь 
разный: разных разные разное 
место: месте места мест местах место 
многие: многие 
верхний: верхнюю 
шорты: шорты 
футболка: футболки 
несколько: несколько нескольких 
штука: штук 
скидываться: скидываемся 
пенсия: пенсию 
дарить: дарю 
благотворительность: благотворительность 
пачка: пачку 
корма: корма 
приют: приют 
происходить: произошло происходит 
незначительный: незначительная 
аренда: аренда аренды 
жилье: жилья 
официальный: официальной официальный официальная 
периодический: периодические 
выплата: выплаты 
кредит: кредит кредиты 
закрывать: закрываю закрыл 
обустройство: обустройство 
выплачивать: выплатил 
переплата: переплата 
второй: второй второго вторых вторые вторая 
этаж: этаж этажа 
нежилой: нежилым 
утеплять: утеплил 
пригодный: пригодным 
иметь: имеет имею 
распоряжение: распоряжении распоряжения 
площадь: площади площадью 
м²: м² 
подымать: поднимают подняли 
балка: балки 
потолок: потолка потолке 
полтора: полтора 
метр: метра 
внешний: внешнюю 
обшивка: обшивку 
стена: стен 
плита: плитами 
осб: осб 
въезжать: въехал 
нормальный: нормальных нормальное 
человек: человека люди людей человеку людям человек 
алкоголь: алкоголь 
считаться: считается 
лекарство: лекарством 
стоматолог: стоматолога 
зуб: зубы зуб 
вылечивать: вылечил 
подавать: подал подали 
документ: документы 
тупить: тупит 
молчать: молчит 
давно: давно 
посещать: посещали 
мысль: мысли 
себя: собой 
малость: малость 
запускать: запустят запустил 
весить: вешу 
кг: кг 
консультация: консультацию 
диетолог: диетологе 
сам: само саму сами самого самому сама 
платный: платную 
апрель: апреле 
пользоваться: пользоваться пользовался 
совет: советами 
поздно: позже 
скидывать: скинул 
вес: вес 
доходить: дошел дойду дойти 
диета: диетой диета 
основывать: основана 
дробный: дробном 
питание: питании 
блюдо: блюда блюдах 
мучной: мучного 
газированный: газированных 
напиток: напитков 
личный: личных личные 
детский: детском детские 
кружок: кружки 
ребенок: детей дети ребенка 
крестница: крестницу крестницей крестница крестницы крестнице 
маленький: маленькая маленький маленькие 
налог: налог налоги 
платить: платим платить платил платят платит 
работодатель: работодатель работодателю 
вести: ведет веду 
хватить: хватит 
анкетный: анкетных 
данный: данных данным 
приступать: приступаю 
творческий: творческой 
мнение: мнения мнению мнение 
некоторые: некоторые некоторых 
скучно: скучно 
особо: особо 
никуда: никуда 
выбираться: выбираюсь 
свободный: свободен свободные 
любить: любит люблю 
проводить: провести проводить 
новорожденный: новорожденной 
дочь: дочери 
хороший: хорошая хороший лучшие хорошей хорошие наилучшими хорошего лучшее 
знакомый: знакомым знакомые знакомых знакомыми знакомы 
говорить: говорю говорим говорил говорят говорит 
врать: вру 
насчет: насчет 
невозможно: невозможно 
притом: притом 
перечислять: перечислять 
вроде: вроде 
куча: куча 
предмет: предметы 
безумный: безумные
обязательный: обязательные 
высоко: выше 
сумма: сумме суммы сумму 
различаться: различаться 
стараться: старается стараюсь стараемся 
лишний: лишних лишнее лишнего лишний 
делать: делаю делать делали делал 
наушник: наушники 
понравиться: понравилась понравились понравился 
иметься: имеющиеся 
сломаться: сломались сломалась 
оплата: оплаты оплатой 
аванс: аванс 
приходить: приходит пришли прихожу пришло приходите пришел 
перекидывать: перекидываю 
класть: кладу 
аналогично: аналогично 
остаток: остатки 
небольшой: небольшой 
дальнейший: дальнейшем 
вернуть: вернуть вернула 
потратиться: потратиться 
оно: оно 
широта: широтой 
душа: души душа 
видно: видно 
проматывать: промотать 
экран: экран 
отдельный: отдельном отдельное отдельный 
копить: коплю копить 
четверг: четверг 
будильник: будильник 
звонить: звонит звоню 
просчитывать: просчитал 
приемка: приемки 
возможный: возможные 
авария: аварии аварий 
путь: пути 
пробка: пробки пробку 
далее: далее 
собираться: соберется собираюсь собираетесь собираемся собраться собрались собирается 
умываться: умылся умыться умываюсь 
выезжать: выеду 
микрорайон: микрорайона 
встревать: встряну 
серьезный: серьезных серьезную 
черта: черте 
отсюда: отсюда 
центр: центр центра 
загруженность: загруженности загруженность 
дорога: дорогу дорога дорог дороге 
третий: третий 
завтра: завтра 
название: названием 
якобы: якобы 
должный: должна должен должны 
повышать: повышать 
знание: знаний 
находиться: находясь находится 
территория: территорию территории 
самый: самой самое самом самый 
потерянный: потерянный 
пропускать: пропустить 
никто: никто никому 
фикция: фикция 
отчитываться: отчитаться 
учить: учат 
спрашивать: спрашивает спрашивают спросить 
то: тому 
опыт: опыта опытом 
почистить: почистил 
снег: снега снегом снег 
поставлять: поставят поставили поставлять поставил поставить 
прогрев: прогрев 
ждать: жду ждал 
поехать: поедем поеду поехал поехали 
мы: нам 
проезжать: проезжает 
мимо: мимо 
отпуск: отпуске отпуск отпуска 
фото: фото 
честно: честно 
нечего: нечего 
показывать: показывать 
окраина: окраине 
вовсе: вовсе 
солнце: солнца 
вечер: вечером вечер 
разговаривать: разговаривают разговариваем 
возвращаться: возвращаемся возвращается 
заезжать: заехали 
молоко: молоко молока 
снека: снека 
трава: травами 
творог: творог творогом 
обожать: обожаю 
собрание: собрание собрании 
выслушивать: выслушиваем 
намолачивать: намолотили 
закром: закрома 
вырабатывать: вырабатывает выработали 
электричество: электричество электричества 
тепло: тепла тепло 
проходить: проходят прошла прошел прошли прошедший 
какой: какое какие 
плохой: плохой плохие плохая 
начинаться: начинается началась 
мыться: моемся моюсь 
душевая: душевой 
мастерская: мастерскую мастерской 
лень: лень 
светиться: светиться 
что: чему 
немного: немного 
добрый: добрый 
жизнерадостный: жизнерадостный 
умный: умный умные умных 
тупой: тупое тупой 
интересный: интересного интересной интересен интересные интересная интересный 
неплохой: неплохой 
шарить: шарю 
десять: десяти десять 
продвижение: продвижение 
служба: службе 
магия: магией 
совать: совать 
палец: пальцы пальцем 
образование: образование 
связанный: связанная связано 
электрика: электрикой 
пойти: пошли пошел пойдет 
избегать: избежать 
армия: армии 
сломать: сломал сломав сломанный 
нога: ногу 
курс: курсе курс 
годный: годен 
учеба: учебы учеба 
неинтересный: неинтересна 
забивать: забито забил 
сей: сих 
пора: пор пора 
доучиваться: доучился 
вуз: вузе 
заочек: заочке 
доводить: довел 
ради: ради 
корочка: корочки 
полагаться: полагался 
сессия: сессий 
сначала: сначала 
младший: младший младшему младшие младшим 
специалист: специалистом специалиста 
ночной: ночной ночными ночную ночная ночных 
четыре: четыре 
сдавать: сдавать сдал сдать 
экзамен: экзамен 
старший: старшим старших старшего 
прибавка: прибавка 
расти: росла 
индексация: индексации 
руководство: руководство руководства 
замечать: заметил замечать 
уставать: уставшие устаешь устаю 
начальство: начальство 
высококвалифицированный: высококвалифицированного 
сводить: свело 
ежесменный: ежесменной ежесменными 
уборка: уборке уборка уборки 
покраска: покраске 
убирать: убирают убрали убирая убирал убрать убирать убираем убирали убираю 
электрооборудование: электрооборудование 
станция: станции станция 
угольный: угольная 
оседать: оседает 
пыль: пыль 
красить: красим 
причина: причинам 
захотеть: захотел 
сменить: смените сменить 
комп: комп компе компами 
айти: айти 
заодно: заодно 
поправлять: поправить 
физический: физические физическую физическая 
форма: форму 
вернуться: вернуться вернулся 
умственный: умственно 
частность: частности 
слушать: слушаем 
выступать: выступить выступающие 
речь: речью 
начальник: начальником начальников начальник начальника начальнику 
цех: цеха 
текучка: текучка 
сильный: сильная 
отдел: отделе отдела 
тридцать: тридцати 
подчиненный: подчиненных подчиненные 
делегировать: делегировать 
общаться: общаемся общался 
постоянно: постоянно 
столовка: столовка столовку 
открываться: открывается 
заканчивать: закончить заканчивать закончил 
обед: обед обеда 
ходить: ходить хожу ходим 
заморачиваться: заморачиваться 
еда: еды едой еда 
короткий: покороче короткий короткую 
мыть: мыть мыли 
посуда: посуду 
народ: народу 
этот: эта 
штрафануть: штрафануть 
сидеть: сидишь сидим сидит 
спать: спит сплю спал спишь спать 
устанавливать: установил установили 
следить: следить следит 
уха: уху ухи 
картошка: картошку картошкой 
котлета: котлетой котлетами 
салат: салатом салат 
компот: компот 
булочка: булочка булочку 
правда: правда 
стул: стульях стул 
хотя: хотя 
научаться: научился 
угодно: угодно 
главное: главное 
точка: точки 
плечо: плечо плечи 
попец: попец 
живот: живот 
голень: голень 
зал: зале зал 
лекция: лекцию 
заполнять: заполнить заполнять заполняю заполнил 
наряд: наряды нарядов нарядам 
допуск: допуск допуски 
сотрудник: сотрудники сотрудников сотрудник 
никакой: никаких никакие 
нарядный: нарядной 
система: система системе 
сотня: сотен сотни 
весь: весь всей 
оперативный: оперативный 
персонал: персонала персонал 
вахта: вахту вахты вахте 
соответственно: соответственно 
следовательно: следовательно 
исходить: исходя 
нехитрый: нехитрых 
подсчет: подсчетов 
пятьсот: пятисот 
пообщаться: пообщались 
замначальник: замначальника 
полчасика: полчасика 
самоподготовка: самоподготовкой 
тип: типа 
кабинет: кабинете кабинета 
читать: читаю читал читаем читать 
книжка: книжки 
обсуждать: обсудили обсуждаем 
прочитывать: прочитанное 
версия: версия 
документалка: документалка 
асафьева: асафьева 
познавательный: познавательный 
канал: канал каналы 
техника: технику технике 
ремесло: ремеслах 
supercrastan: supercrastan 
даня: даня 
крастереть: крастер 
тыща: тыщу 
относить: отнес 
ключ: ключ ключами 
хранение: хранения 
приятный: приятная 
погода: погода 
минус: минус 
ветер: ветер 
случаться: случился 
мороз: мороз 
уезжать: уехал уехали уехать 
любой: любом 
пополам: пополам 
ништяк: ништяк 
три: трех 
доезжать: доеду доехал 
поиграть: поиграть поиграл 
охранять: охраняет 
наш: нашей нашем наш наша 
перекусить: перекусил перекусить 
кусочек: кусочки кусочком кусочками 
курица: курицу курицы 
запекать: запеченной 
духовка: духовки духовке 
макароны: макаронами 
нга: нг 
впрок: впрок 
маман: маман 
вчера: вчера 
сготовить: сготовила 
порезать: порезал 
подниматься: поднялся поднимаюсь 
эх: эх 
освещение: освещение 
доделывать: доделал 
лето: летом 
проводка: проводку 
кинуть: кинул 
светильник: светильников светильник светильники 
розетка: розетку розетки 
щиток: щиток 
автомат: автомат автоматами 
успевать: успела успел успеть 
холодно: холодно 
тянуть: тянет тянуть 
кабель: кабель 
перезапитывать: перезапитать 
фонарик: фонариком 
включать: включаю включить включил включено включу 
напольный: напольный 
прекрасный: прекрасное 
коробочка: коробочку 
картонный: картонное 
разрывать: разорвала 
разметать: разметала 
м: м 
убираться: убраться убирайся 
ругать: ругать 
смысл: смысла смысл 
существо: существо 
развлекаться: развлекалась развлекалось 
устраивать: устроили устроишь устроила 
беспорядок: беспорядок 
пылесос: пылесос 
вперед: вперед 
изолировать: изолирована 
клетка: клетки 
летать: летала 
иначе: иначе 
проблема: проблема проблемы проблем проблемами проблеме 
психологический: психологические 
садиться: сажусь сел 
писать: писали пишет пишут писать пишу 
писаться: пишется 
сайт: сайте сайтом 
фоновый: фоновый 
пошло: пошло 
описывать: описывать 
dayz: dayz 
часик: часиков 
укладывать: уложена уложу 
сменный: сменной сменного сменное 
белье: белье 
завтрашний: завтрашнего 
собирать: соберу собрать собрал собери собираю 
контейнер: контейнеры контейнере 
рассчитывать: рассчитывал 
ложиться: ложиться лег лечь 
проигрывать: проиграл 
допоздна: допоздна 
уснуть: уснул усну уснуть 
пятница: пятница пятницу 
ветка: ветке 
звонок: звонок звонка 
попискивать: попискивать 
возмущаться: возмущается 
разбудить: разбудил 
сумка: сумку 
закинуть: закинул 
сыр: сыром сыр 
варение: вареньем варенье 
переставать: перестала перестал 
волшебный: волшебной 
наполнять: наполненной 
ожидание: ожиданием 
большинство: большинство большинства 
число: числе число числа 
уменьшаться: уменьшится 
сонный: сонная 
намного: намного 
повезти: повезет 
ладно: ладно 
пусть: пусть 
отдыхать: отдохнуть отдыхаем отдыхает отдыхаю 
вызывать: вызвал вызываю 
покидать: покидал 
одеваться: оделся 
собакен: собакен 
выглядывать: выглянул выглядывать 
будка: будки 
заспанный: заспанный 
довольный: довольным довольный 
понимание: понимании 
выскочить: выскочить 
радоваться: радоваться 
хозяин: хозяину 
рань: рань 
пес: псу пес 
судя: судя 
команда: команду 
быстро: быстрее быстро 
почитать: почитать 
нафлуживать: нафлудили 
чатик: чатик чатиках 
таксист: таксист 
выбирать: выбрал 
связь: связью 
инвестирование: инвестированию 
независимость: независимость 
гедонизм: гедонизм 
просматривать: просматриваю 
крастер: крастера 
подумать: подумать подумал 
позвонить: позвонить позвонил позвонила 
факт: факт факту 
починять: починят починили починить 
значит: значит 
таксо: таксо 
заходить: заходит захожу 
медик: медику медик 
мерить: мерит мерить 
давление: давление 
дышать: дышать 
трубочка: трубочку 
алко: алко 
проходной: проходной 
алкорамка: алкорамка 
контролировать: контролировать 
тупость: тупости 
плохо: плохо хуже 
упасть: упал 
высота: высоты 
недопуск: недопуск 
лично: лично 
чувствовать: чувствую 
оказываться: оказалась оказывается оказалось 
прыгать: прыгает 
благо: благо 
докапываться: докапываться 
переодеваться: переодевшись переодеваемся переоделся 
роба: робу робе 
прошлый: прошлой прошлых 
чистый: чистую 
стирка: стирки 
примета: примета 
прийти: придут придешь 
обязательно: обязательно 
отправлять: отправят 
грязный: грязное грязном 
пыльный: пыльное 
поделать: поделать поделаешь 
уходящий: уходящей 
заваривать: завариваем завариваю заварил 
чай: чай 
чайничек: чайничке 
рассыпной: рассыпной 
пакетик: пакетиках 
энергетический: энергетический 
частично: частично 
он: нему 
добавлять: добавил добавляю 
обычный: обычная обычного обычный обычную обычным 
черный: черной черный черное 
мята: мяты 
вместо: вместо 
сахар: сахар сахара 
безумно: безумно 
вкусно: вкусно 
чаепитие: чаепитие 
допивать: допить 
чашка: чашку 
заявка: заявка заявки заявку 
выдавать: выдает выдал выдать 
фининди: фининди 
тема: теме темы 
граница: границей 
почему: почему 
сводиться: сводится 
принимать: принял принимает принимаем принимающих примут 
журнал: журнал журнала 
активно: активно 
нести: несут 
допускать: допускать допускал 
бумага: бумаг 
стол: столе 
навалить: навалено 
столько: столько 
ужас: ужас 
разгребать: разгрести 
записывать: записать 
бегать: бегаешь бегаем 
савраска: савраски 
параллельно: параллельно 
работник: работник работников 
двое: двое 
оборудование: оборудование оборудованию оборудования оборудованием 
самостоятельно: самостоятельно 
ты: тебе 
ставить: ставят 
восьмерка: восьмерку 
называться: называется 
дублирование: дублирования 
обязанный: обязан 
ознакомляться: ознакомиться 
часы: часы 
документация: документацией 
изменение: изменение изменениями 
обязанность: обязанности 
присмотр: присмотром 
вид: видом виде 
деятельность: деятельностью 
приносить: принесут принес принести 
покрасить: покрасить 
вводить: введена 
отдых: отдыха 
изменяться: измениться изменилось изменилась 
схема: схема схемы схему 
отключать: отключаю отключать отключено 
снова: снова 
действовать: действующая действует 
дробно: дробно 
питаться: питаться 
подход: подходе подхода 
перерыв: перерывом 
макарошка: макарошки 
курочка: курочкой 
хлеб: хлеба хлеб 
вкусный: вкусный 
суп: супы 
разнообразие: разнообразие 
полный: полное 
вплоть: вплоть 
домашний: домашней домашнее домашний 
выпечка: выпечки 
градирня: градирни 
вход: вход 
кпп: кпп 
полдень: полдня 
прой: прое 
скрываться: скрывался 
отлично: отлично 
хитрый: хитрый 
лентяй: лентяй 
высказывать: высказали 
немой: нем 
обеденный: обеденное 
годок: годков 
касаться: касается коснулась 
твой: твоей твоих 
готовый: готов 
возражение: возражений 
назначать: назначают 
тихий: тихое 
слабость: слабость 
спокойный: спокойной 
поломка: поломок 
младшоя: младшой 
жучар: жучара 
хитропопый: хитропопый 
поесть: поесть поели поел 
момент: момента моменты 
жесть: жесть 
разбирать: разбери разобрал 
включаться: включается 
отключаться: отключилась отключились отключается отключиться 
свет: свет 
погасать: погас 
вставлять: вставил 
обходчик: обходчику 
заливать: залить залил залили 
темнота: темноте 
двигатель: двигатель двигателя 
кнопка: кнопку 
держать: держу держит 
отпускать: отпускаю 
разбираться: разобрался разобрались разбираться 
надеяться: надеюсь надеялся 
пройти: пройдет 
тихо: тихо 
вытаскивать: вытащил 
аппаратура: аппаратурой 
осматривать: осматривать осматриваем осмотрел 
мешать: мешало мешает 
потыкать: потыкал 
пускатель: пускателя пускатель 
похожий: похожего 
стоячий: стоячего 
блок: блок блока блоке блоков 
надобность: надобности 
потащить: потащил 
притаскивать: притащенная 
пуск: пуска 
механически: механически 
залипать: залипаем залипает залипать залипаю 
фаза: фаз 
нажатие: нажатии 
ремперсонал: ремперсонал 
чинить: чини 
интересно: интересно 
чувствоваться: чувствуется 
мечта: мечтах 
скоро: скоро скорее 
сменщик: сменщики 
щит: щите 
помещение: помещении помещения 
вызов: вызов 
электролизный: электролизной электролизную электролизная 
подскакивать: подскакиваем 
бежать: бежим 
добегать: добегаем 
шаг: шагом 
семь: семь 
срочно: срочно 
простой: простоя 
сложность: сложностей 
водород: водорода водородом водород 
вода: вода воды воду 
охлаждать: охлаждает 
генератор: генераторы генераторов 
потребление: потребление 
сутки: сутки 
запас: запас запасы запаса 
производить: производит 
прибегать: прибегаем 
кислород: кислородом 
сторона: сторону 
сразу: сразу 
подтверждаться: подтвердилась 
открывать: открыть открывать 
автоматически: автоматически 
побежать: побежал 
чудо: чудо 
буквально: буквально 
фух: фух 
везти: повезло везти 
выравниваться: выровнялось 
режим: режим 
знатный: знатного 
адреналин: адреналина 
благостный: благостные 
полчаса: полчаса 
аварийный: аварийные 
обратный: обратном 
проходная: проходную 
выход: выход 
договариваться: договорились договориться 
встречаться: встретиться 
закупиться: закупился 
бутылка: бутылкой бутылки 
негазированный: негазированной 
вкус: вкусом 
лимон: лимона лимоном 
газировать: газированной 
банка: банку 
кофеек: кофейку 
попить: попить попьешь 
молочка: молочку 
пятилитровка: пятилитровку 
птица: птице птиц 
нарезной: нарезной 
пакет: пакет пакеты 
касса: кассу 
некислый: некислый 
дорогой: дорогой 
послезавтра: послезавтра 
тренировка: тренировки тренировок тренировку тренировкой 
понедельник: понедельник 
забор: забор 
приезжать: приехали приезжаю приезжать приехал 
физнагрузка: физнагрузка 
сорок: сорок 
больная: больная 
спина: спина спине спины 
насыпать: насыпаю насыпал насыпало 
свежий: свежего 
примерный: примерным примерное 
высыпаться: выспаться выспался 
вставать: вставать встаю 
девять: девяти 
великий: великая 
пытка: пытка 
шанс: шанс 
просыпаться: проснулся проснусь проснуться 
нормально: нормально 
специально: специально 
подъем: подъем 
надавать: надают 
будни: будни 
непереводимый: непереводимая 
игра: игра игры игру 
слово: слов 
бред: бред 
топать: топаем 
трое: троих трое 
косяк: косяков 
докладывать: докладываю 
слепой: слепое 
вспоминать: вспоминаю 
распечатывать: распечатанное 
прослеживать: проследить 
дополнительно: дополнительно 
неплохо: неплохо 
позалипать: позалипать позалипал 
ита: ит 
блюстительница: блюстительница 
голова: головой 
захотеться: захотелось 
поработать: поработать 
пропадать: пропадать 
рвение: рвению 
повседневный: повседневные 
крыша: крыша 
протекать: протекает 
гречка: гречка гречку 
острый: острый 
кетчуп: кетчуп 
вспомнить: вспомнить вспомнил 
новое: нового 
баночка: баночка 
домашние: домашние 
теплица: теплица 
участок: участок 
сотка: соток 
чисто: чисто 
огород: огороде огород 
постройка: построек 
вопрос: вопросов 
равно: равно 
охлаждение: охлаждение 
чистота: чистота 
оч: оч 
соприкасаться: соприкасается 
вещество: веществами 
масло: масла 
трубка: трубок трубки 
циркулировать: циркулирует 
грязноватый: грязноватые 
падать: падает 
выдувать: выдувать 
задувать: задувать 
нужно: нужно 
продолжать: продолжал 
вырабатываться: вырабатываться 
несчастливый: несчастливое 
слышать: слышали слышал 
хлопок: хлопка хлопок 
пятый: пятом пятый 
сварочный: сварочные 
рубильник: рубильники рубильника рубильник 
сварка: сварка сварку 
предполагать: предполагаемого 
запах: запах 
гари: гари 
дым: дымом 
горелый: горелой 
изоляция: изоляцией 
пробовать: пробовал пробую 
замок: замок 
болт: болта 
закручивать: закрученного 
резьба: резьбе резьбу 
крутиться: крутится 
хм: хм 
сорвать: сорвал 
выкручивать: выкрутив 
обнаруживать: обнаружил 
аж: аж 
привариваться: приварился 
заглядывать: заглядываю 
внутрь: внутрь 
коробка: коробки коробку коробке 
вокруг: вокруг 
питать: питающий 
немаленький: немаленькую 
дырка: дырку 
сквозной: сквозную 
внутри: внутри 
сплавляться: сплавились 
прозванивать: прозванивать 
определяться: определяться 
смочь: сможем 
исправлять: исправить 
ситуация: ситуацию 
напряжение: напряжение 
целый: целый 
полблок: полблока 
предстоящий: предстоящими 
заскакивать: заскочить 
попросить: попросила 
прогуливаться: прогуляюсь прогулялся 
пешком: пешком 
недалеко: недалеко 
пятнадцать: пятнадцать 
неспешный: неспешным 
замечательный: замечательную 
картина: картину 
лопата: лопату 
справляться: справился 
эксперимент: эксперимент 
шатер: шатер 
ткань: ткани ткань 
самодельный: самодельный 
сваривать: сварили 
сомнение: сомнения 
оправдываться: оправдались 
порваться: порвалась 
зайти: зашел 
справка: справки 
картофель: картофель 
закупать: закупал 
осень: осенью 
мешок: мешков 
майонез: майонез 
мясо: мясо 
ужин: ужин 
бесплатный: бесплатный 
задротить: задротим задротить 
полночь: полночь 
четвертый: четвертый 
воскресение: воскресенье 
фиг: фиг 
присниться: приснилось 
треня: треню 
вчерашний: вчерашней 
полазить: полазил 
намести: намело 
район: району районе 
тщательно: тщательно 
тротуар: тротуаров 
разминаться: разомнусь 
кардио: кардио 
аллея: аллея 
дерево: деревья 
ряд: ряда 
двадцать: двадцать 
тренер: тренера тренер тренеру тренером 
программа: программа программу 
план: плану 
рука: рук руки 
смог: смог 
перенести: перенесем перенесли 
выполнение: выполнения 
назаниматься: назанимался 
велосипед: велосипеде 
любоваться: любуюсь 
рядом: рядом 
елочка: елочками 
стукнуть: стукнул стукнуло 
понянчиться: понянчиться 
обратно: обратно 
ничто: ничем 
пук: пуков 
удивлять: удивляет 
нянчиться: нянчиться 
необычно: необычно 
поза: позы 
пельмень: пельмени 
манта: манты 
полезть: полез 
подраться: подраться 
катать: катать 
бить: бить 
норма: норм норму 
искупаться: искупалась 
тазик: тазике 
наблюдать: наблюдает 
засаживаться: засел 
стрим: стримы 
отоспаться: отосплюсь 
пробуждение: пробуждения 
тяжелый: тяжелый 
поспать: поспать 
залезать: залез 
отправляться: отправляюсь отправился 
гулять: гулять 
проходиться: пройтись 
погодка: погодка 
спокойно: спокойно 
увязать: увязая 
сугроб: сугробах 
лампочка: лампочку лампочки 
коридор: коридора 
специальный: специальном 
нестандартный: нестандартная 
дворик: дворики 
перо: перьями 
расплачиваться: расплачиваюсь 
сон: сон 
занимать: занята заняла 
чирикать: чирикает 
успокаивать: успокоить 
нереально: нереально 
беруш: беруши 
штора: шторы 
засыпать: засыпаю 
некоторый: некоторое 
успокаиваться: успокаивается 
усаживаться: усаживается 
перекус: перекус 
удивление: удивление 
странно: странно 
пик: пик 
привыкать: привык 
ковид: ковид 
побриться: побриться 
помыться: помыться 
туалет: туалете 
посидеть: посидеть 
грохнуть: грохнул 
хватать: хватает 
единственный: единственное 
азот: азот 
ремонтировать: ремонтировать 
традиция: традиция 
втроем: втроем 
говяжий: говяжий 
остренький: остренький 
свое: свое 
очередь: очереди 
умудряться: умудрился 
доламывать: доломал 
крутить: крутили 
многий: многих 
сильно: сильно 
шумно: шумно 
разговор: разговоры 
отдельность: отдельности 
шестой: шестой 
вторник: вторник 
заканчиваться: закончилась 
происшествие: происшествий 
директор: директору директор 
счастливый: счастливые 
заваливаться: завалился 
помогать: помогаю помочь помог 
съездить: съездить 
осмотр: осмотр 
вздремнуть: вздремнул 
тяжело: тяжело 
перекусывать: перекусываю 
бутер: бутером 
оттуда: оттуда 
тащиться: тащиться 
ваща: ваще 
резон: резон 
воспитывать: воспитайте воспитывает 
закреплять: закрепить 
люлька: люльку люльке 
вдвоем: вдвоем 
последить: последить 
прием: приеме 
доносить: донесу 
поликлиника: поликлинике 
поболтать: поболтать 
пролезать: пролез 
прикол: прикол 
разница: разница 
дистанция: дистанцию 
подобный: подобное 
насколько: насколько 
переменный: переменных 
высчитываться: высчитывается 
запись: записей 
засобираться: засобирался 
налегке: налегке 
душ: душ 
обход: обход 
готовиться: готовиться 
переход: переход 
предстоять: предстоит 
чистить: чистим чистить 
тишина: тишина 
радовать: радовать 
однако: однако 
поговорить: поговорив 
долгий: долгое 
следование: следования 
протирать: протереть 
муха: мух 
напарник: напарником 
белый: белые 
пятно: пятна 
плафон: плафоны 
лист: листов 
прозрачный: прозрачного 
пластика: пластика 
кончаться: кончился кончились 
зае: зае 
сила: силы сил 
скроллить: скроллить 
утренний: утренняя 
седьмой: седьмой 
тупо: тупо 
порция: порцию 
глаз: глаз глаза 
чайный: чайную 
ложка: ложку 
крупный: крупных 
неохота: неохота 
отлынивать: отлынивать 
орел: орел 
гора: горы 
сарделька: сарделькой 
близко: ближе 
ох: ох 
четко: четко 
упражнение: упражнения 
тренажерка: тренажерке 
комплекс: комплексы 
меняться: меняются 
расписывать: расписаны 
надоедать: надоедают надоели 
парк: парк 
продолжаться: продолжается 
родные: родных 
дописывать: дописываю 
долго: подольше 
восьмой: восьмой 
поход: походов 
закусь: закусь 
общак: общак 
компания: компании компания 
параллельный: параллельной 
рановато: рановато 
яичница: яичницу 
колбаса: колбасой 
завтрак: завтрак 
посмотреть: посмотрел 
сериал: сериалы сериал 
сезон: сезон 
полоса: полосы 
впечатление: впечатления 
популярный: популярные популярное 
кальмар: кальмара 
козырек: козырьки 
дракон: дракона 
почесать: почесал 
пивнушка: пивнушки 
кобра: кобра 
бассейн: бассейн 
чумовой: чумовой 
длинный: длинный 
теплый: теплый 
плыть: плывешь 
край: края 
кайф: кайф 
тело: тело 
болеть: болит 
парилка: парилке 
облегчение: облегчение 
подарить: подарили 
брелок: брелок 
отзыв: отзыв 
посещение: посещения 
крутой: крутой 
оттого: оттого 
приоткрывать: приоткрыли 
окно: окно 
политика: политика политику 
затрагивать: затрагиваем 
власть: власть 
законодательство: законодательство 
мобилизация: мобилизация 
скооперироваться: скооперировались 
клип: клипы 
постель: постели 
отнимать: отнял 
снимок: снимки 
заранее: заранее 
текст: текст 
затем: затем 
подбирать: подберем подобрать 
течение: течение 
цель: цель 
разводить: развести 
холивар: холивар 
коммент: комментах 
увеличивать: увеличить 
энтропия: энтропию 
мир: мира 
подтягивать: подтяну 
указывать: укажите 
предпочтение: предпочтения 
читатель: читатели 
делиться: делятся 
тэг: тэги 
обложка: обложке 
ксения: ксения 
михайлов: михайлова 
сэкономить: сэкономили 
комментарий: комментарии комментариях 
модерация: модерацию 
правило: правилам правила правило 
riddler: riddler 
герой: герой 
откидываться: откинулись 
штраф: штрафы 
заставлять: заставляют 
отвечать: ответить 
creep: creep 
сад: саду 
винсент: винсент 
ламповый: лампово 
напоминать: напомнило 
простоквашино: простоквашино 
статья: статьи 
еще: ещё 
колено: колени 
ломить: ломить 
хвост: хвост 
кхм: кхм 
поберечь: поберегите 
anna: anna 
сердечко: сердечко 
сейлор: сейлор 
марс: марс 
антонио: антонио 
стиль: стиль стиля 
подача: подачи 
написание: написания 
печенька: печенька 
тж: тж 
троллить: троллить 
комментатор: комментаторов 
коллекция: коллекцию 
редакция: редакция 
деваться: делись 
уасяпупкин: уасяпупкин 
жена: женами 
временно: временно 
xd: xd 
недостойный: недостойные 
предатель: предатели 
предавать: предают 
завод: завод 
отредактировать: отредактировано 
причем: причем 
достойный: достойная достойных 
увидеть: увидела 
намек: намека 
lupus: lupus 
est: est 
некогда: некогда 
kirill: kirill 
p: p 
новость: новостей 
заголовок: заголовками 
европейский: европейский европейских 
молодой: молодой молодых 
мужчина: мужчин 
восточный: восточной 
южный: южной 
европа: европе европы 
фу: фу 
ценность: ценности 
касимова: касимова 
танзиля: танзиля 
элементарно: элементарно 
нехетти: нехетти 
грин: грин 
троллинг: троллинг 
пытаться: пытался 
эмпатия: эмпатия 
puteshestvenitcage: puteshestvenitcage 
айтишник: айтишники 
udali: udali 
покушать: покушать 
ирина: ирина 
ой: ой 
поржать: поржала 
mary: mary 
ocean: ocean 
секси: секси 
широкий: широкие 
komarova: komarova 
противоречие: противоречие 
настя: насть 
little: little 
hippo: hippo 
учет: учетом 
позволять: позволю 
изучать: изучить изучать изучаете 
теория: теорией теорию 
тестирование: тестирования 
область: области 
наставник: наставник 
вкатиться: вкатиться 
глубоко: глубоко 
копать: копать 
нюанс: нюансы 
запрос: запроса 
select: select 
включая: включая 
объединение: объединение 
база: баз базу база 
webursitet: webursitet 
прямой: прям 
базовый: базовая 
взаимодействие: взаимодействие 
код: коды 
ошибка: ошибок 
джун: джунов 
повидать: повидала 
фич: фичи 
переходить: переходить 
proxyman: proxyman 
подмена: подмена 
трафик: трафика 
интересность: интересности 
взгляд: взгляд 
must: must 
книга: книгу 
guide: guide 
software: software 
test: test 
design: design 
извинять: извините 
уверенный: уверена 
адаптация: адаптации 
сожаление: сожалению 
джуна: джуны джунам 
рваться: рвутся 
автоматизация: автоматизацию 
упускать: упуская 
автоматизировать: автоматизировать 
нынче: нынче 
перегревать: перегрет 
wannabe: wannabe 
требование: требования 
ощутимо: ощутимо 
ниже: ниже 
готовность: готовности 
основа: основе 
dg: dg 
приятно: приятно 
критиковать: критиковать 
полезный: полезное полезного 
starушка: starушка 
спасибо: спасибо 
лоб: лбу 
ковырять: ковыряю 
html: html 
sql: sql 
собственный: собственного 
удобство: удобства 
задалбывать: задалбывает 
ерунда: ерунды ерунда 
списочек: списочки 
составлять: составить составляю 
глянуть: гляну 
вылупливать: вылупив 
скромно: скромно 
понятно: понятно 
помучиться: помучиться 
зато: зато 
губа: губу 
закатывать: закатывают 
предлагать: предлагают 
проверять: проверить 
заботиться: заботиться 
прижимать: прижали 
конкретный: конкретный 
означать: означает 
минимизация: минимизацию 
риск: рисков риски 
защита: защиту 
будущее: будущем 
охрана: охраны 
труд: труда труды 
поменяться: поменялось 
кровохлебка: кровохлебка 
жениться: жениться 
невеста: невесты 
богиня: богиня 
тлен: тлена 
чесать: чешет 
venividivici: venividivici 
регион: региона 
стремиться: стремится 
мед: медом 
намазывать: намазано 
нико: нико 
вечно: вечно 
съезжать: съезжайте 
худеть: худейте 
родить: родите 
чужой: чужого 
нетоксичный: нетоксичные 
мадам: мадам 
радостно: радостно 
исход: исхода 
ненавистный: ненавистного 
мордор: мордора 
валинор: валинор 
дерзать: дерзайте 
провод: провода 
градообразующий: градообразующем 
генерировать: генерирующим 
реальный: реальные 
тмц: тмц 
тестировать: тестируя 
очередной: очередное 
годноприложение: годноприложение 
полноценный: полноценных 
успешный: успешных 
повторный: повторный 
исправление: исправлением 
жизненный: жизненных 
пожелание: пожеланиями 
ева: ева 
ц: ц 
смертельный: смертельный 
неожиданно: неожиданно 
мера: меры 
предпринимать: предпринять 
несчастный: несчастного 
майский: майская 
вступление: вступление 
похоже: похоже 
сбор: сбор 
штамп: штампов 
неужели: неужели 
egor: egor 
alexandrovich: alexandrovich 
токсичный: токсичная 
создавать: создавать 
тикать: тикают 
загадка: загадка 
бабки: бабки 
лавочка: лавочки 
подъезд: подъезда 
залетать: залетают 
темич: темич 
супергерой: супергерой 
школьник: школьнику 
руководитель: руководителя 
декрет: декрете 
аланья: аланьей 
экономист: экономист 
москва: москве 
розничный: розничной 
сеть: сети 
поволжье: поволжье 
бали: бали 
ереван: ереване 
владелец: владелец 
пвз: пвз 
оператор: оператор 
установка: установки 
нефтяной: нефтяной 
уфа: уфе 
безработный: безработный 
студент: студент 
студентка: студентка 
биоинформатика: биоинформатик 
немецкий: немецком 
киль: киле 
репетитор: репетитора репетитор 
русский: русскому 
язык: языку 
белград: белграде 
фрилансер: фрилансер 
кемерово: кемерове 
менеджер: менеджер 
реклама: рекламе 
подмосковье: подмосковье 
инженер: инженер 
приволжский: приволжском 
федеральный: федеральном 
округ: округе 
колледж: колледжа 
красноярск: красноярске 
бухгалтер: бухгалтера 
крым: крыму 
мошенник: мошенникам 
каникулы: каникулы 
инвалидность: инвалидностью 
уведомлять: уведомлять 
белоруссия: белоруссии 
ипать: ип 
оформлять: оформить 
сотрудничать: сотрудничают 
сосед: соседи 
дверной: дверную 
ручка: ручку 
клей: клеем 
протест: протест 
завещание: завещание 
муж: мужа 
имущество: имущество 
здание: здание 
баланс: баланс 
багаж: багажом 
возникать: возникали 
косметичка: косметичка 
уход: уход 
чувствительный: чувствительной 
комбинированный: комбинированной 
кожа: кожей 
акна: акне 
последствие: последствия 
покупатель: покупателя 
продавец: продавец 
вносить: внесет 
доля: доли 
отрабатывать: отработала 
срок: срок 
целевой: целевому 
договор: договор договору 
посылка: посылка 
застревать: застряла 
таможня: таможне 
стаут: стауты 
гоза: гозе 
ламбик: ламбики 
крафтовый: крафтовое 
въезд: въезда 
сербия: сербию 
россиянин: россиян 
поколение: поколение 
девяностый: девяностых 
беспроводный: беспроводные 
колонка: колонки 
удачный: удачных 
модель: моделей 
классный: классные 
apple: apple 
watch: watch 
вакансия: вакансии 
сообщать: сообщить 
проект: проекте 
контакт: контакты 
конфиденциальность: конфиденциальности 
пользование: пользования 
ао: ао 
банк: банк 
лицензия: лицензия 
