недвижимость: недвижимость недвижимости 
учебник: учебник 
сравнятор: сравнятор 
сообщество: сообщество 
ипотека: ипотеку ипотека ипотеки ипотеке 
кредитный: кредитная 
история: историй история истории 
тест: тесты 
дневник: дневники дневник 
трата: трат 
налоговый: налоговый 
вычет: вычет вычеты 
написать: написать 
инвестиция: инвестиции 
бизнес: бизнес 
разбор: разборы 
закон: законов законах 
калькулятор: калькуляторы 
путешествие: путешествия 
медицина: медицина 
здоровье: здоровье 
подкаста: подкасты 
видео: видео 
смотреть: смотреть 
сервис: сервисы 
расчет: расчеты 
закладка: закладки 
письмо: письма 
оставаться: остался оставайтесь 
деньги: деньгами 
поток: потоки 
нужно: нужно 
знать: знать 
покупать: покупать покупают 
продавать: продают продавал продавать продали 
снимать: снимать 
жилье: жилье 
делать: делать делал делают 
ремонт: ремонт ремонта ремонте 
экономить: экономить 
жку: жку 
ольга: ольга 
лурье: лурье 
жить: живу 
дом: дом 
это: это 
бывший: бывшая 
баня: баня 
необычный: необычных 
место: места 
жизнь: жизни 
alexander: alexander 
читатель: читатели 
четыре: четыре 
дома: дома 
какой: какими каким 
проблема: проблеме проблемами 
сталкиваться: столкнулся 
новостройка: новостройке 
редакция: редакция 
дискуссия: дискуссии 
плохой: худший 
сосед: сосед 
ваш: вашей 
почитать: почитать 
налог: налоги 
аренда: аренда 
покупка: покупка покупке 
продажа: продаже продажа 
жкх: жкх 
анастасия: анастасия 
советовый: советова 
финансовый: финансовое 
чутье: чутье 
усадьба: усадьба 
век: века 
угадывать: угадайте 
сколько: сколько 
стоять: стоит 
сумасшедший: сумасшедшее 
корнилов: корнилова 
получать: получить 
краткий: краткая 
инструкция: инструкция 
елена: елена 
антипова: антипова 
обустройство: обустройство 
обустраивать: обустроили 
площадь: площадью 
м²: м² 
мэл: мэл 
чикал: чикалов 
нужный: нужны 
нотариус: нотариуса 
дистанционно: дистанционно 
доля: доли долю долями 
квартира: квартире квартиры квартиру квартир 
наталия: наталия 
сивонина: сивонина 
изумительный: изумительные 
подрядчик: подрядчик 
сделать: сделать сделал 
некачественный: некачественный 
заказчик: заказчик 
итог: итоге 
должный: должен должны 
людмила: людмила 
соколовский: соколовская 
купить: купила купили 
программа: программе 
бюджетник: бюджетников 
ангелина: ангелина 
дронова: дронова 
стильный: стильных 
полезный: полезных 
предмет: предметов 
интерьер: интерьера 
свой: своими своей 
рука: руками 
николай: николай 
валюха: валюх 
инвестразбор: инвестразборы 
рынок: рынок 
россия: россии 
заканчиваться: закончился 
год: год 
ждать: ждать 
александр: александр 
муратов: муратов 
дача: дачи 
загородный: загородные 
курятник: курятник 
алиса: алиса 
маркина: маркина 
помогать: помочь 
власть: власти 
сгорать: сгорел 
частный: частный 
мы: нам 
позитивный: позитивных 
константин: константин 
каупуш: каупуш 
совет: советов 
зимний: зимний 
сезон: сезон 
starушка: starушка 
хотеть: хотел 
находить: нашли 
способ: способ 
ссориться: ссориться 
время: время 
валерия: валерия 
ринсо: ринсо 
бюджетный: бюджетно 
освежать: освежила 
балкон: балконе 
максим: максим 
чурилов: чурилов 
зарабатывать: заработать 
срочный: срочном 
выкуп: выкупа выкупе 
вероника: вероника 
нецова: нецова 
район: район районе 
встречаться: встречаются 
пугать: пугающие 
контраст: контрасты 
житься: живется 
московский: московском 
кузьминки: кузьминки 
грудинина: грудинина 
супруга: супруге 
отказываться: отказаться 
рефинансировать: рефинансировали 
однушка: однушку 
детский: детскими 
взамен: взамен 
двушка: двушку 
упрощение: упрощение 
незначительный: незначительной 
другой: другие 
изменение: изменения 
судебный: судебные 
сносить: сносят 
незаконный: незаконные 
постройка: постройки 
судно: суда 
становиться: стали 
платить: платить 
коммуналка: коммуналку 
поделиться: поделитесь 
боль: болью 
пузырь: пузырь 
лопнуть: лопнет 
недостаток: недостатков 
господдержка: господдержкой 
вакансия: вакансии 
сообщать: сообщить 
проект: проекте 
контакт: контакты 
политика: политика 
конфиденциальность: конфиденциальности 
правило: правила 
пользование: пользования 
сайт: сайтом 
выходить: выйти 
ао: ао 
банк: банк 
лицензия: лицензия 
