дефицит: дефицитом дефицит дефиците дефицита 
бюджет: бюджета бюджету бюджет бюджете 
январь: январю январе январем января январь 
разбирать: разбираем 
причина: причины причине причиной 
последствие: последствий последствия 
превышение: превышения 
расход: расходов расходы расходам 
доход: доход доходам доходы доходами доходов 
промой: промо 
увеличивать: увеличив увеличьте 
сообщество: сообществом сообщество 
инвестор: инвесторам инвесторов 
это: этим это 
работать: работает 
учебник: учебник учебники 
сравнятор: сравнятор 
ипотека: ипотека 
кредитный: кредитная 
история: историю история истории 
тест: тесты 
дневник: дневники дневник 
трата: трат 
налоговый: налоговые налоговую налогового налоговая налоговый 
вычет: вычет 
написать: написать 
инвестиция: инвестиции 
бизнес: бизнесу бизнес бизнеса 
разбор: разборы 
закон: законе законов закон 
калькулятор: калькуляторы 
путешествие: путешествия 
медицина: медицина медицины 
здоровье: здоровье 
недвижимость: недвижимость 
подкаста: подкасты 
видео: видео 
смотреть: смотреть 
сервис: сервисы 
расчет: расчеты 
закладка: закладки 
письмо: письма 
оставаться: остались оставшимся оставайтесь 
деньги: деньгами деньги денег 
поток: потоки 
экономика: экономике экономика 
минфин: минфине минфин минфина 
отчитываться: отчитался 
рекордный: рекордного рекордном рекордными рекордных рекордный 
происходить: произошло происходить происходящего происходит 
февраль: феврале февраля 
исполнение: исполнение исполнении 
федеральный: федеральный федерального 
год: год году лет года годом 
сравнение: сравнения сравнению 
сокращаться: сократились сокращаются 
треть: треть 
вырастать: выросли вырастут выросла 
итог: итогам итоге 
они: ними 
образовываться: образовалась 
пропасть: пропасть 
размер: размер размером 
трлн: трлн 
рубль: рублей 
самый: самую самое самый 
крупный: крупных крупнейшим крупный 
январский: январских январский январские январском 
современный: современный современную 
российский: российскому российская российский российских российском российскую российской российского 
половина: половины 
запланировать: запланированного 
разбираться: разбираемся разберись 
отчего: отчего 
выходить: вышло выйти вышел 
повлиять: повлияло повлияет 
положение: положение 
дело: дел дело 
игорь: игорь 
жулькин: жулькин 
следить: слежу следит следят следите 
новость: новости новостями 
профиль: профиль 
автор: автора 
курс: курсе курс 
общаться: общаться 
понимать: понимаю понял понимать 
друг: друг друга 
бесплатный: бесплатный 
бережно: бережно 
окружающий: окружающими 
часто: чаще 
получать: получал получить получать получили получают получает 
желать: желаемое 
изучать: изучить изучать 
почему: почему 
наполняемость: наполняемости наполняемость 
казна: казна казны казну 
сильно: сильно 
зависеть: зависит 
налог: налогом налогов налоги налога налог 
производитель: производителей производителю 
энергоресурсы: энергоресурсов 
доля: доля доли 
годовой: годовом годовой 
план: план плану 
составлять: составляет составило составить составила составив составили 
главный: главным главной 
сокращение: сокращения 
бюджетный: бюджетным бюджетной бюджетных 
поступление: поступлений поступления поступлению 
становиться: станет стал становится стали стала 
низкий: низкая низкие 
цена: цене цены цен ценах цену цена 
продавать: продаваемую продать 
рубеж: рубеж 
нефть: нефтью нефть нефти 
снижение: снижение 
объем: объемов объемы 
экспорт: экспорта 
газ: газом газ газа 
предприятие: предприятия 
нефтегазовый: нефтегазовым нефтегазового нефтегазовые 
сектор: сектора 
пополнять: пополнили пополнить 
млрд: млрд 
вдвое: вдвое 
мало: меньше 
прошлое: прошлого прошлом 
дешевый: дешевая 
очевидно: очевидно 
марка: марка марки марке 
urals: urals 
подешеветь: подешевела 
баррель: баррель 
назад: назад 
торговаться: торговалась 
раз: раза 
дорогой: дороже 
учет: учетом 
котировка: котировок котировкам 
привязывать: привязана 
экспортный: экспортной экспортная 
пошлина: пошлины пошлина 
падать: падают 
стремительно: стремительно 
дешеветь: дешевеет 
ввод: ввода 
нефтяной: нефтяных нефтяного нефтяной 
эмбарго: эмбарго 
потолок: потолка потолок 
ес: ес 
декабрь: декабре декабрь 
сохранять: сохранить 
добыча: добычи добычу добыча 
сбыт: сбыта 
экспортер: экспортеры 
вынуждать: вынуждены 
делать: делать 
существенный: существенные 
скидка: скидки 
покупатель: покупателя покупателям покупатель 
вступать: вступили 
сила: силу 
какой: какую какие каким каких 
ждать: ждать 
первый: первом первую первый 
очередь: очередь 
связанный: связано 
сложный: сложной 
логистика: логистика логистикой 
поставка: поставки 
азия: азию 
затратный: затратнее 
европа: европу европа 
также: также 
приходиться: приходится 
считаться: считаться считавшийся 
риск: риски рисками 
вторичный: вторичных 
санкция: санкций санкции 
который: который которые которых которой которая 
нести: несут 
контрагент: контрагенты 
наш: нашего нашем наших 
нефтяник: нефтяников 
россия: россия россии 
оказываться: оказалась оказались оказаться 
ситуация: ситуации ситуация 
диктовать: диктует 
продавец: продавец 
дисконт: дисконт дисконтом 
эталонный: эталонной 
brent: brent 
достигать: достиг 
источник: источником источник источников 
газовый: газовая газовые 
просадка: просадка 
непростой: непростая 
рост: росте рост 
продажа: продажей продажи продаж продажу 
китай: китае китай 
неоднократно: неоднократно 
отмечать: отмечали отмечают 
компенсировать: компенсирует 
потеря: потери 
конец: конце 
поддерживать: поддержали 
перечисление: перечисления 
вид: виде 
разовый: разового 
полезный: полезных 
ископаемое: ископаемых 
октябрь: октября 
монополист: монополист 
ежемесячно: ежемесячно 
выплачивать: выплачивал 
дополнительный: дополнительных дополнительные 
фон: фоне 
этот: этих 
вливание: вливаний 
выглядеть: выглядят 
скромный: скромными 
сумма: сумме суммы сумму 
соответствующий: соответствующие 
запаздывать: запаздывающие 
остальной: остальным 
статья: статьям статье статьи статью статья 
совокупно: совокупно 
проседать: просели 
ндс: ндс 
прибыль: прибыль 
объяснять: объясняет объяснили объяснить 
сборы: сборы 
внутренний: внутреннем внутреннего 
добавлять: добавленную 
стоимость: стоимость стоимости 
новое: нового 
порядок: порядка 
возмещение: возмещения возмещением 
действовать: действуют действовать действует 
апрель: апреля 
он: нему 
государство: государство 
возвращать: возвращает 
организация: организациям 
уплачивать: уплаченный 
ранее: ранее 
быстро: быстрее 
поддержка: поддержка 
обзор: обзор 
основной: основных 
мера: мер 
принимать: принял принятых 
март: марте 
рано: раньше рано 
процедура: процедуру процедура 
занимать: занимала 
месяц: месяца месяцем месяц 
несколько: несколько 
день: дней 
активно: активно 
пользоваться: пользуется 
квартальный: квартальные 
перераспределяться: перераспределяются 
основное: основном 
следовательно: следовательно 
должный: должна должен должны 
высоко: выше 
министерство: министерства министерстве 
исчислять: исчисленный 
декларация: декларациям 
уплата: уплатой уплаты 
квартал: квартале 
показатель: показателей показателя 
ведомство: ведомстве 
оценивать: оценили 
собираемость: собираемость 
введение: введение 
единый: единый единого 
счет: счет счета счетах 
призванный: призван 
упрощать: упростить 
взнос: взносов 
быть: будут буду будем 
перечисляться: перечисляться 
один: одним одно 
платеж: платежа платежом платеж 
платить: платил платить 
сдавать: сдавать 
отчет: отчеты отчет 
новый: новые новая новый новейшей 
механизм: механизм 
сдвигать: сдвинул 
срок: срок сроки 
зачисление: зачисления 
сказываться: сказалось скажутся 
график: графике 
состояние: состоянию 
нераспределенный: нераспределенными 
общий: общем 
рф: рф 
изменение: изменение 
ненефтегазовый: ненефтегазовые 
западный: западных 
переставать: перестанут перестал 
публиковать: публиковать 
детализировать: детализированный 
знать: знаем знаете знаю знать 
тратить: тратила тратит 
лишь: лишь 
мочь: можем могут можешь могу могли могла 
видеть: видеть 
итоговый: итоговый итоговую 
именно: именно 
фактор: фактором факторов 
начинать: начнет начала 
поскупиться: поскупился 
объяснение: объяснения 
скачок: скачка 
ссылаться: сослались 
ускоренный: ускоренное 
заключение: заключение 
контракт: контрактов 
ранний: раннее 
авансирование: авансирование 
уточнять: уточнив 
сделка: сделках 
идти: идет 
речь: речь 
госзакупки: госзакупки 
превышать: превысили 
пять: пять 
потратить: потратило 
перенос: переносом 
часть: часть части 
необходимость: необходимость 
появляться: появились появилась 
сведение: сведения 
трехлетний: трехлетнего 
характер: характер 
непредвиденный: непредвиденных 
раскрывать: раскрывать 
далеко: дальше 
динамика: динамику 
афишировать: афиширует 
прогнозировать: прогнозировать 
проблематичный: проблематично 
перспектива: перспективы 
доходный: доходной 
представляться: представляются 
ясный: яснее 
продолжать: продолжат продолжать 
влиять: влиять 
отношение: отношении 
ограничение: ограничения 
запрет: запретом 
морской: морские 
сырой: сырой 
нефтепродукт: нефтепродуктов 
вводить: введены 
предельный: предельные 
дизель: дизеле дизель 
мазут: мазут мазуте 
аналогичный: аналогичный 
очередной: очередное очередной 
затрагивать: затронет 
большой: большим большую большой 
нефтепереработчик: нефтепереработчиков 
рынок: рынком рынке 
факт: факт 
получаться: получается получится 
перенаправлять: перенаправить 
индия: индии 
сильный: сильная 
нефтеперерабатывающий: нефтеперерабатывающая 
промышленность: промышленность 
поэтому: поэтому 
потребность: потребности 
такой: такие такое 
закупка: закупки 
наверняка: наверняка 
считать: считая считают 
эксперт: эксперты 
отрицательно: отрицательно 
предвидеть: предвидя 
недобор: недобор 
решение: решения решение 
втрое: втрое 
наращивать: нарастить 
изъятие: изъятия 
фонд: фонда 
национальный: национального 
благосостояние: благосостояния благосостоянии 
цикл: цикл 
валюта: валюты 
резерв: резервов 
кубышка: кубышку 
золото: золота золотом 
правительство: правительстве правительству 
рассчитывать: рассчитывают 
обеспечивать: обеспечивать обеспечивают 
устойчивость: устойчивость 
система: систему системы 
фнб: фнб 
юань: юаней 
оно: оно 
ограничивать: ограничивает 
компенсация: компенсации 
недополученный: недополученных 
впервые: впервые 
пойти: пошел 
масштаб: масштабы 
пока: пока 
скоро: скоро скорее 
символический: символические 
тонна: тонны 
иметься: имеющихся 
похоже: похоже 
рукав: рукаве 
другой: другие другое другую 
вариант: варианты 
увеличение: увеличения 
заявлять: заявили 
прорабатывать: прорабатывают проработали 
переход: переход 
альтернативный: альтернативную 
налогообложение: налогообложения 
отрасль: отрасли 
сми: сми 
версия: версии версия 
реализовывать: реализован реализовать 
отвязывать: отвязать 
поставлять: поставлять поставить 
прямой: прямую 
зависимость: зависимость зависимости 
стремиться: стремиться 
договариваться: договариваться 
хороший: лучших лучшие хороший хорошую 
условие: условий условиях 
сокращать: сокращать 
свой: свои свой своих 
срабатывать: сработает 
вообще: вообще 
говорить: говорю говорить говоря 
исходить: исходить 
плановый: плановых 
закладывать: заложенных 
заканчивать: закончить 
недосчитываться: недосчиталась 
сценарий: сценарий 
базовый: базовым 
маловероятный: маловероятен 
нынешний: нынешних 
пророчить: пророчат 
ниже: ниже 
нужно: нужно 
касаться: касаются 
подписываться: подписывайтесь 
тэг: тэги 
актуальный: актуальное 
фотография: фотография 
обложка: обложке 
alex: alex 
milan: milan 
istock: istock 
статистика: статистике статистикой 
комментарий: комментария комментарии комментариях 
проходить: проходят 
модерация: модерацию 
правило: правилам правила 
журнал: журнала 
владимир: владимир владимира 
половинка: половинка 
кажется: кажется 
связывать: связать 
некоторый: некоторыми 
процесс: процессами 
бросаться: бросились 
глаз: глаза 
отвечать: ответить 
барышня: барышня 
герой: герой 
отредактировать: отредактировано 
догадываться: догадаться 
секрет: секрет 
полишинель: полишинеля 
уверенный: уверена 
польза: пользу 
мы: нам 
врать: врать 
прямо: прямо 
возвращаться: возвращаемся 
заголовок: заголовку 
сергей: сергей 
данные: данные 
рамка: рамках 
некорректный: некорректным 
сопоставлять: сопоставлять 
цифра: цифрами 
средство: средствами 
непонятный: непонятного 
вставать: встает 
колено: колен 
спасибо: спасибо 
мудрый: мудрому 
вождь: вождю 
тьфунатебать: тьфунатебя 
легенда: легенда 
думать: думают думать думал думаю думаете 
читать: читал читаю читаете 
ветер: ветер 
бухать: бухает 
проперживать: проперживает проперживать 
диван: диваны диван 
absofrutly: absofrutly 
еще: ещё 
сосед: соседей соседи 
отбирать: отбирает 
евгений: евгений 
сарказм: сарказм 
валентин: валентин 
че: че 
ироничный: ироничное 
слышать: слышать 
власть: власти 
вечный: вечное 
хотеть: хотите хочет хочу 
девяностый: девяностых девяностые 
таки: таки 
захотеть: захотим 
снова: снова 
вернуть: вернем вернуть 
ванг: ванга 
рассказывать: расскажите 
пенсионер: пенсионерам пенсионеров 
например: например 
официальный: официальной 
экономить: экономит 
еда: еде 
andre: andre 
macareno: macareno 
счастие: счастью 
мир: мире мир 
добрый: добрых 
человек: люди людей человеку людям человек 
находить: найти 
vag: vag 
diagnost: diagnost 
настольный: настольная 
импортозамещенный: импортозамещенной 
playstation: playstation 
красный: красный 
мимо: мимо 
кошкин: кошкина 
барыня: барыня 
смутный: смутное 
подозрение: подозрения подозрение 
ум: ума ум 
прикладывать: приложу 
антиконсьюмерист: антиконсьюмерист 
государственный: государственном 
личный: личном 
отдельный: отдельных 
что: чему 
приплетать: приплел 
сюда: сюда 
ваньш: ваньша 
оспаривать: оспорить оспорь 
утверждение: утверждение 
искажать: искази 
смысл: смысл 
искаженный: искаженное 
судя: судя 
твой: твоим 
высказывание: высказываниям 
отлипать: отлипаешь 
родина: родин 
михаил: михаил 
зато: зато 
чиновник: чиновников 
морда: морды 
монитор: мониторы 
тв: тв 
помещаться: помещаться 
олигарх: олигархов 
бедный: бедных 
фантазия: фантазия 
заканчиваться: заканчивается 
яхта: яхты 
круизный: круизный 
лайнер: лайнер 
имение: имения 
небоскреб: небоскребы 
абрамович: абрамович 
ярд: ярдов 
украина: украине украины 
подарить: подарил 
неплохой: неплохая 
помощь: помощь 
сказать: скажите 
зарабатывать: заработали 
честный: честным честный 
труд: труда трудом труд 
вместе: вместе 
поржать: поржем 
хотя: хотя 
рабский: рабский 
завод: заводах 
копейка: копейки 
miramax: miramax 
сша: сша 
банкрот: банкроты 
тайвань: тайвань 
поджигать: поджигают 
правильно: правильнее 
тальков: тальков 
петь: пел 
сто: сто 
век: веков 
судебный: судебная 
практика: практика 
видимо: видимо 
выбор: выбора 
некогда: некогда 
великий: великого великой 
британия: британией 
вячеслав: вячеслав 
дмитриевич: дмитриевич 
фокус: фокус 
т: т 
е: е 
приходить: приходит прихожу 
вятский: вятского 
квас: квас кваса 
магазин: магазине 
продаваться: продаешься 
соответственно: соответственно 
брать: брать 
кол: колы 
стоять: стоит 
нефтянка: нефтянка 
просто: просто 
убыточный: убыточной 
момент: момент 
сам: самих 
себестоимость: себестоимость 
немного: немного 
арабский: арабских 
страна: страны стран странах 
впложивать: вплодь 
доллар: долларов 
регион: региона 
очень: очень 
джоконда: джоконда 
слезать: слезем 
игла: иглу иглы 
светлана: светлана 
белянкин: белянкина 
садиться: сядем 
политика: политика 
стратег: стратега 
наверное: наверное 
виктор: виктор 
низовцев: низовцев 
сей: сих 
пора: пор 
отпускать: отпускает 
выживать: выжить 
повышать: повысят повысит 
сырье: сырья 
внутри: внутри 
приводить: приведет 
резкий: резкому 
скачка: скачку 
бензин: бензин 
дт: дт 
шах: шах 
мат: мат 
vadim: vadim 
rybalko: rybalko 
классика: классика 
папа: папа 
пить: пить 
сынок: сынок 
филипп: филипп 
правый: правы 
писаться: писалось 
множество: множества 
сложность: сложности 
разведка: разведки 
качество: качества 
многий: многих 
месторождение: месторождениях 
плохо: хуже 
саудит: саудитами саудиты 
путать: путайте 
скважина: скважину 
сделать: сделать 
качать: качать 
качественный: качественную 
вечно: вечно 
мерзлота: мерзлоте 
туда: туда 
труба: трубу 
дотащить: дотащить 
теплый: теплое 
мягкий: мягким 
несправедливый: несправедливом 
распределение: распределении 
ресурс: ресурсов 
изменять: изменить 
практически: практически 
никто: никто 
собираться: собирается 
жизнь: жизнь 
справедливый: справедлива 
гражданин: граждан 
большинство: большинство 
нищий: нищие 
тыс: тыс 
придумывать: придумают придумали 
минимум: минимум 
прожиточный: прожиточный 
паек: паек 
сдыхать: сдохнуть 
голод: голоду 
пенсия: пенсии 
коммуналка: коммуналку 
оплачивать: оплатить 
купить: купить 
лекарство: лекарства 
одежда: одежду 
бытовой: бытовую 
химия: химию 
отдых: отдых 
молчать: молчу 
младший: младший 
медперсонал: медперсонал 
зп: зп 
москва: москве москвой 
тд: тд 
рождаться: родился 
малый: малом 
город: городе 
нить: нить 
рязанский: рязанской 
область: области 
извинять: извини 
рыло: рылом 
жить: жил живет 
бесконечно: бесконечно 
конь: конь 
пальто: пальто 
картинка: картинка 
топ: топ 
дмитрий: дмитрий 
экономический: экономические экономического 
модель: модели моделей 
принципиально: принципиально 
разный: разные разных 
скажем: скажем 
два: двух 
отличие: отличие 
покрытие: покрытия 
кроме: кроме 
каннибализм: каннибализма 
повышение: повышение 
секвестр: секвестр 
погуглить: погуглите 
прежде: прежде 
писать: писать 
саудовский: саудовской 
аравия: аравии 
район: районе 
намного: намного 
сложно: сложнее 
минэнерго: минэнерго 
ребя: ребя 
замечать: заметить 
усложняться: усложнилась 
оборудование: оборудование 
доставать: доставать 
поспорить: поспоришь 
дурак: дураком дурак 
ковалев: ковалев 
работа: работа 
пусть: пусть 
наполнять: наполнить 
привыкать: привыкли 
сидеть: сидеть 
аватарка: аватарка 
пояс: пояса 
затягивать: затягивать 
настоящий: настоящая 
тянуть: тянуть 
латание: латания 
дыра: дыр 
развитие: развития развитие 
наука: науки 
обычный: обычным 
ровно: ровно 
путь: пути 
реализация: реализация 
принудительный: принудительные 
заимствование: заимствования 
реализоваться: реализуется 
наращиваться: наращиваться 
дальнейший: дальнейшем 
никакой: никаких 
позитивный: позитивных 
метод: методов 
проблема: проблемы проблеме 
заясь: заясь 
б: б 
boris: boris 
barista: barista 
тот: те той 
чувство: чувство 
накрываться: накрылся 
медный: медным 
таз: тазом 
сюрприз: сюрприз 
user: user 
продых: продыху 
juliya: juliya 
voronova: voronova 
иллюстрация: иллюстрация 
класс: класс 
удаваться: удалось 
отлично: отлично 
полетать: полетать 
гражданский: гражданском 
самолет: самолете 
советский: советское 
время: время 
ничто: ничто 
мешать: мешало 
восстанавливать: восстановят восстановили восстановить 
производство: производство 
близкий: ближайшие 
жирный: жирным 
шрифт: шрифтом 
прочитывать: прочитайте 
совершенно: совершенно 
правда: правда 
небольшой: небольшие 
выпуск: выпуском 
узел: узлов 
деталь: деталей 
тогдашний: тогдашнего 
уровень: уровня 
этап: этап 
авиастроение: авиастроения 
мошенник: мошенникам 
понадобиться: понадобились 
справка: справки 
репетитор: репетитор 
полагаться: полагался 
каникулы: каникулы 
инвалидность: инвалидностью 
копить: копить 
покупать: покупать 
балл: баллы 
уведомлять: уведомлять 
белоруссия: белоруссии 
работник: работник 
товар: товары 
работодатель: работодателю 
ипать: ип 
молодой: молодой 
оформлять: оформить 
машина: машину 
сотрудничать: сотрудничают 
иностранный: иностранным 
заливать: залили 
дверной: дверную 
ручка: ручку 
замок: замок 
клей: клеем 
протест: протест 
ремонт: ремонта 
завещание: завещание 
ребенок: дети детей 
муж: мужа 
имущество: имущество 
здание: здание 
баланс: баланс 
багаж: багажом 
возникать: возникали 
поездка: поездках 
косметичка: косметичка 
уход: уход 
чувствительный: чувствительной 
комбинированный: комбинированной 
кожа: кожей 
акна: акне 
вносить: внесет 
сколько: сколько 
обучение: обучение 
отрабатывать: отработала 
целевой: целевому 
договор: договор договору 
процент: проценты 
популярный: популярное 
неделя: неделю 
посылка: посылка 
застревать: застряла 
таможня: таможне 
стаут: стауты 
гоза: гозе 
ламбик: ламбики 
место: мест 
крафтовый: крафтовое 
пиво: пиво 
бали: бали 
зарплата: зарплатой 
въезд: въезда 
сербия: сербию 
россиянин: россиян 
мнение: мнение 
поколение: поколение 
лишний: лишнее 
беспроводный: беспроводные 
колонка: колонки 
удачный: удачных 
директор: директор 
розничный: розничной 
сеть: сети 
поволжье: поволжье 
экономист: экономист 
дежурный: дежурный 
электромонтер: электромонтер 
новосибирск: новосибирске 
классный: классные 
впечатление: впечатления 
apple: apple 
watch: watch 
вакансия: вакансии 
сообщать: сообщить 
проект: проекте 
контакт: контакты 
конфиденциальность: конфиденциальности 
пользование: пользования 
сайт: сайтом 
ао: ао 
банк: банк 
лицензия: лицензия 
