купить: купить 
акция: акциями акции акций акция 
спб: спб 
биржа: биржа бирже биржи биржу 
стоимость: стоимость 
сегодня: сегодня 
прогноз: прогноз 
цена: цен цена 
котировка: котировками котировки 
график: графике графиками 
динамика: динамика динамику 
курс: курса 
онлайн: онлайн 
банк: банк банке банки банком 
бизнес: бизнес бизнеса 
касса: касса кассы 
инвестиция: инвестиций инвестиция инвестиции 
страхование: страхование 
путешествие: путешествия 
город: город 
доля: долями 
входить: войти войдите 
обзор: обзор 
каталог: каталог 
пульс: пульс пульсе 
аналитика: аналитика 
академия: академия 
скринер: скринер 
терминал: терминал 
spbe: spbe 
доходность: доходность 
полгода: полгода 
сектор: сектора сектору сектор 
финансовый: финансовых финансовый 
новость: новости новостях новостей 
компания: компании компания компанию компаний 
являться: является 
крупный: крупные крупных крупнейшим крупнейшей 
организатор: организатором 
торги: торгам торгах торгов 
иностранный: иностранными иностранных 
ценный: ценных ценными ценную ценные 
бумага: бумагами бумаги бумаг бумагу 
рамка: рамках 
российский: российской российских российском 
юрисдикция: юрисдикции 
создавать: создает 
инвестиционный: инвестиционный инвестиционная инвестиционных инвестиционной инвестиционные 
возможность: возможности 
частный: частных 
инвестор: инвесторов 
счет: счет счета счетов 
широкий: широкого 
спектр: спектра 
инструмент: инструментов 
официальный: официальные официальный 
сайт: сайте сайт 
страна: страна 
россия: россия россии 
показатель: показатели 
торговый: торговая торговые торговый торгового 
данные: данные 
параметр: параметры 
открытие: открытия 
закрытие: закрытия 
дневной: дневной 
диапазон: диапазон 
изменение: изменение 
день: день 
год: год году года 
годовой: годовой 
код: код 
идентификатор: идентификатор 
режим: режима 
spbru: spbru 
isin: isin 
лотность: лотность 
лот: лот 
квалифицированный: квалифицированных 
валюта: валютами валют валюта 
rub: rub 
интересный: интересное 
пост: посты 
thirdwave: thirdwave 
февраль: февраля 
глобальный: глобальный 
разбор: разбор разборов 
часть: часть 
первый: первую 
мочь: можете 
просматривать: просмотреть 
канал: канале 
дитя: дитя 
mdmg: mdmg 
происходить: произошло происходит 
пробитие: пробитие 
нисходящий: нисходящего 
тренд: тренда 
считать: считаю 
это: это 
фейк: фейк 
далеко: дальше 
ожидать: ожидает 
рост: рост 
подходить: подошли подошла 
мой: моем моей 
зона: зоне зоны 
покупка: покупке покупки 
вывод: вывод 
очевидный: очевиден 
цель: цели цель целями 
давать: даст давал 
рано: раньше 
тинькофф: тинькофф 
tcsg: tcsg 
думать: думаю 
быть: будем 
закрывать: закрывать 
гэп: гэп 
далее: далее 
минимальный: минимальная 
инарктика: инарктика 
aqua: aqua 
сильный: сильной 
поддержка: поддержке поддержки 
образовывать: образуем 
двойной: двойное 
дно: дно 
пойти: пойдем 
вверх: вверх 
новатэк: новатэк 
nvtk: nvtk 
находиться: находимся 
возле: возле 
вероятный: вероятен 
отскок: отскок 
важный: важных 
прочий: прочего 
находить: найти 
рекомендация: рекомендацией 
рынок: рынок рынке рынка рынку 
место: место 
торговля: торговлю торговля 
облигация: облигациями 
прочее: прочими 
актив: актива активов активами 
понятие: понятие 
затрагивать: затрагивает 
функция: функцию 
передача: передачи 
другой: другие 
операция: операции 
они: ними 
такой: такие 
выпуск: выпуск 
налогообложение: налогообложение 
кроме: кроме 
позволять: позволяет 
устанавливать: установлены устанавливать 
справедливый: справедливое 
ценообразование: ценообразование 
определенный: определенные определенным 
признак: признаки 
фиксировать: фиксированная 
площадка: площадки площадка 
федерация: федерации 
московский: московская 
moex: moex 
специализированный: специализированный 
механизм: механизм 
отбор: отбора 
товар: товаров 
отвечать: отвечающих 
требование: требованиям 
процедура: процедуры 
время: времени 
стандарт: стандартам 
оформление: оформление 
сделка: сделку сделка сделок сделке 
централизованно: централизованно 
деятельность: деятельность деятельности 
участник: участников участники 
контролироваться: контролируется 
уполномоченный: уполномоченными 
орган: органами 
существовать: существуют 
полноценный: полноценной 
работа: работы работа 
многосоставный: многосоставная 
инфраструктура: инфраструктура 
функционал: функционал 
самый: самой самых 
система: система системы 
оперировать: оперируют 
профессиональный: профессиональные 
среди: среди 
брокер: брокеры 
дилер: дилеры 
организация: организации 
вовлекать: вовлеченные 
непосредственно: непосредственно 
обеспечение: обеспечением обеспечение 
процесс: процессы процесса 
заниматься: занимаются 
технический: технические 
клиринговый: клиринговые 
центр: центры 
депозитарий: депозитарии 
регистратор: регистраторы 
информационный: информационными информационное 
взаимодействовать: взаимодействует 
агентство: агентствами 
деловой: деловой 
пресса: прессой 
новичок: новичкам 
госсектор: госсектор 
два: двух 
гигант: гигантов 
ваш: вашему 
мнение: мнению 
становиться: станет 
лидер: лидером 
близкий: ближайший 
заставать: застанет 
переломный: переломный 
момент: момент 
взгляд: взгляд 
хороший: лучшая 
который: которая 
все: всему 
приятный: приятные 
бенефит: бенефиты 
также: также 
подверженный: подверженна 
сильно: сильно 
влияние: влиянию 
конкретный: конкретную 
условный: условная 
просадка: просадке просадка 
потенциал: потенциале 
включение: включения 
санкция: санкции 
поэтому: поэтому 
сделать: сделаю 
ставка: ставку 
она: неё 
зацеплять: зацепил 
последний: последние 
какой: какие каких 
избавляться: избавлялись 
акционер: акционеры 
фондовый: фондовом 
проходить: прошло 
несколько: несколько 
headhunter: headhunter 
qiwi: qiwi 
энерго: энерго 
рассказывать: расскажу 
подробно: подробнее 
каждый: каждую 
смысл: смысл 
полагаться: полагаться 
золото: золото 
аренда: аренду 
недвижимость: недвижимости 
стоять: стоит 
обращать: обращать 
внимание: внимание 
китайский: китайских 
расширять: расширит 
количество: количество 
основной: основных 
interfax: interfax 
ключевой: ключевые 
событие: события 
среда: среды 
рф: рф 
мир: мире 
капитал: капитал 
твориться: творится 
турция: турции 
джанет: джанет 
йелльный: йеллен 
решать: решила 
избегать: избежать 
рецессия: рецессии 
дайджест: дайджест 
мск: мск 
допускать: допустит 
freedom: freedom 
holding: holding 
казахстан: казахстане 
запускать: запустят 
длительный: длительными 
сессия: сессиями 
известно: известно 
золотодобыча: золотодобыче 
оборот: обороты 
мосбиржа: мосбирже 
январь: январе 
список: список 
популярный: популярных 
частый: частые 
вопрос: вопросы 
еще: ещё 
относиться: относятся 
финансы: финансы 
афк: афк 
эсэфай: эсэфай 
tcs: tcs 
group: group 
bank: bank 
holder: holder 
физический: физическому физическим 
лицо: лицу лицам 
приобретать: приобрести 
открывать: открыть открыв 
индивидуальный: индивидуальный индивидуальной 
брокерский: брокерский брокерской 
представлять: представленные 
доступный: доступна доступны 
шорты: шорт 
маржинальный: маржинальная 
недоступный: недоступна 
похожий: похожие 
личный: личный 
кабинет: кабинет 
один: одной 
составлять: составляет 
рубль: рублей 
производиться: производится 
лонг: лонг 
ознакомляться: ознакомиться 
отслеживать: отследить 
информация: информация информацию 
размер: размере 
дивиденд: дивидендов 
узнавать: узнать 
влиять: влияющих 
инвестировать: инвестировав 
данный: данную 
зарабатывать: заработали 
вложенный: вложенной 
сумма: суммы 
этот: эта 
звонок: звонков 
кредитный: кредитные 
карта: карты 
дебетовый: дебетовые 
премиум: премиум 
кредит: кредит кредиты 
наличные: наличными 
рефинансирование: рефинансирование 
автокредит: автокредит 
вклад: вклады 
платеж: платежи 
подписка: подписка 
pro: pro 
tinkoff: tinkoff 
private: private 
осаго: осаго 
каско: каско 
граница: границу 
ипотека: ипотека 
квартира: квартира 
дом: дом 
здоровье: здоровье 
блог: блог 
авиабилет: авиабилеты 
отель: отели 
тур: туры 
билет: билеты 
лететь: лететь 
малый: малый 
расчетный: расчетный 
регистрация: регистрация 
эквайринг: эквайринг 
госзакупки: госзакупки 
продажа: продажи 
бухгалтерия: бухгалтерия 
депозит: депозиты 
проверка: проверка 
контрагент: контрагентов 
бонус: бонусы 
кино: кино 
театр: театры 
концерт: концерты 
ресторан: рестораны 
доставка: доставка 
продукт: продуктов 
салон: салоны 
красота: красоты 
топливо: топливо 
автомобиль: автомобили 
haval: haval 
модель: модели 
jolion: jolion 
f: f 
dargo: dargo 
h: h 
гарантия: гарантия 
большой: большой 
сервис: сервисы 
выплата: выплаты выплат 
вэд: вэд 
облачный: облачные 
выставление: выставление 
безналичный: безналичные 
чаевые: чаевые 
отраслевой: отраслевые 
решение: решения 
оплата: оплата 
безопасный: безопасная 
карьера: карьера 
клиент: клиентами 
иис: иис 
тариф: тарифы 
esim: esim 
перенос: перенос 
номер: номер номера 
роуминг: роуминг 
красивый: красивые 
запись: запись 
виртуальный: виртуальный 
секретарь: секретарь 
олег: олег 
точка: точки 
пополнение: пополнения 
банкомат: банкоматы 
курсы: курсы 
контакт: контакты 
помощь: помощь 
investors: investors 
получатель: получателей 
услуга: услуг 
депонент: депонентов 
ао: ао 
лицензия: лицензия 
осуществление: осуществление 
депозитарный: депозитарной 
выдавать: выданы 
г: г 
ограничение: ограничения 
срок: срока 
действие: действия 
универсальный: универсальная 
цб: цб 
english: english 
