калькулятор: калькуляторов калькулятор калькуляторы 
учебник: учебник 
сравнятор: сравнятор 
сообщество: сообщество 
ипотека: ипотеку ипотека 
кредитный: кредитная 
история: история 
тест: тесты 
дневник: дневники дневник 
трата: трат 
налоговый: налоговый налоговым 
вычет: вычет вычеты 
написать: написать 
инвестиция: инвестиции 
бизнес: бизнес 
разбор: разборы 
закон: законов 
путешествие: путешествия 
медицина: медицина 
здоровье: здоровье 
недвижимость: недвижимость 
подкаста: подкасты 
видео: видео 
смотреть: смотреть 
сервис: сервисы 
расчет: расчеты 
закладка: закладки 
письмо: письма 
оставаться: оставайтесь 
деньги: деньгами 
поток: потоки 
помогать: помогут 
спланировать: спланировать 
бюджет: бюджет 
рассчитываться: рассчитаться 
долг: долги долгами 
накапливать: накопить 
крупный: крупные 
покупка: покупки 
узнавать: узнать узнайте 
дата: дату 
наступление: наступления 
финансовый: финансовым финансовой финансовый финансовое финансовые 
независимость: независимости 
александра: александра 
меньшиков: меньшикова 
какой: какие 
страна: страны 
принимать: принимают 
турист: туристов 
россия: россии 
виктория: виктория 
зорина: зорина 
главный: главных 
число: чисел 
тот: тех 
дорожить: дорожит 
свой: своим свой 
будущий: будущим 
катя: катя 
прокудин: прокудина 
бинго: бинго 
переживать: пережили 
год: год лет году 
удаваться: удалось 
сделать: сделать 
почитать: почитать 
налог: налогов налоги 
экономия: экономия 
кредит: кредиты 
анастасия: анастасия 
троянова: троянова 
партнерский: партнерский 
материал: материал 
выгодно: выгодно 
становиться: стать станете 
tinkoff: tinkoff 
елена: елена 
глубко: глубко 
тинькофф: тинькофф 
журнал: журнала 
случай: случаи 
жизнь: жизни 
сколько: сколько 
заплатить: заплатят 
декретный: декретный 
отпуск: отпуск 
ольга: ольга 
лурье: лурье 
делать: делать 
ущемлять: ущемляют 
ваш: ваш ваши вашему 
право: права 
работа: работе 
рыбаков: рыбакова 
нерезидент: нерезидентом 
редакция: редакция 
зарабатывать: заработаете заработать 
дебетовка: дебетовке 
black: black 
олеся: олеся 
огурцов: огурцова 
ребенок: ребенку 
пора: пора 
следующий: следующий 
медосмотр: медосмотр 
персональный: персональный 
календарь: календарь 
вика: вика 
лобанова: лобанова 
нога: ног 
голова: головы 
базовый: базовый 
гардероб: гардероб 
одежда: одежды 
российский: российских 
бренд: брендов 
увольнять: увольняют 
смочь: сможете 
взять: взять 
льготный: льготную 
чекап: чекап 
проверять: проверьте проверить 
свое: свое 
кредитка: кредитке 
гасить: гасить 
досрочно: досрочно 
перечислять: перечислять 
вклад: вклад 
отпускник: отпускника 
мочь: можете 
тратить: тратить 
день: день 
артем: артем 
иволгин: иволгин 
благодаря: благодаря 
получать: получает 
государство: государство 
прививка: прививки 
нужный: нужны 
алексей: алексей 
каблучок: каблучков 
надежность: надежность 
исполнитель: исполнителя 
интерактивный: интерактивный 
заказчик: заказчиков 
клиент: клиентов 
который: которые 
пригождаться: пригодятся 
кашубин: кашубина 
конструктор: конструктор 
составлять: составьте 
список: список 
аэропорт: аэропорту 
пошло: пошло 
справочник: справочник 
пассажир: пассажиров 
совет: советы 
инфляция: инфляция 
квартира: квартирах 
бигмак: бигмаках 
айфон: айфонах 
изменяться: изменился 
уровень: уровень 
вакансия: вакансии 
сообщать: сообщить 
проблема: проблеме 
проект: проекте 
контакт: контакты 
политика: политика 
конфиденциальность: конфиденциальности 
правило: правила 
пользование: пользования 
сайт: сайтом 
выходить: выйти 
ао: ао 
банк: банк 
лицензия: лицензия 
