фонд: фонда фонд фонду фондов фонды фонде 
благосостояние: благосостояния 
норвегия: норвегия норвегии 
потерять: потерял потеряете потеряли 
млрд: млрд 
доллар: долларов 
причина: причинами причины 
последствие: последствия 
убыток: убытков убытках убытки убыток 
промой: промо 
увеличивать: увеличила увеличивал увеличьте увеличивайте 
доход: доходов доходом доходы доход 
сообщество: сообществом сообщество 
инвестор: инвесторам инвесторы инвесторов инвестором 
это: этим это 
работать: работает работал 
учебник: учебник 
сравнятор: сравнятор 
ипотека: ипотека 
кредитный: кредитная 
история: история 
тест: тесты 
дневник: дневники дневник 
трата: трат 
налоговый: налоговые налоговую налоговый 
вычет: вычет 
написать: написать 
инвестиция: инвестиций инвестиции инвестициях 
бизнес: бизнес бизнеса 
разбор: разборы 
закон: законов 
калькулятор: калькуляторы 
путешествие: путешествия 
медицина: медицина 
здоровье: здоровье 
недвижимость: недвижимость недвижимости 
подкаста: подкасты 
видео: видео 
смотреть: смотреть 
сервис: сервисы 
расчет: расчеты 
закладка: закладки 
письмо: письма 
оставаться: оставайтесь 
деньги: деньгами деньги денег 
поток: поток потоки 
инвестразбор: инвестразборы 
норвежский: норвежской норвежском норвежский 
какой: какие какими 
вывод: выводы 
стоять: стоит 
сделать: сделать сделаю 
отчитываться: отчитался 
размер: размере размер размеру 
итог: итогам 
год: год годов году лет года 
рекордный: рекордные рекордному рекордный 
время: время времен 
существование: существования 
результат: результат результатов результаты результата 
работа: работы 
минус: минус 
операция: операций операциям 
акция: акциями акциях акции акциям акций 
составлять: составленными составил составить составила составили составленный 
облигация: облигации облигациями облигациях облигациям облигаций 
приносить: принесли приносить 
доходность: доходности доходность 
несмотря: несмотря 
вырастать: вырос выросли 
крона: крон кроны 
удаваться: удалось 
достигать: достичь 
благодаря: благодаря 
приток: притоку 
капитал: капитала капиталом капитал капитале 
трлн: трлн 
ослабление: ослаблению 
создавать: создали 
инвестировать: инвестировать инвестирует 
государство: государства 
продажа: продажи 
нефть: нефть нефти 
газ: газ газа 
крупный: крупнейшим крупнейшая крупный крупнейшие крупнейший крупные 
поставщик: поставщик 
энергоноситель: энергоносителей 
сокращение: сокращения 
поставка: поставками поставок 
россия: россии 
страна: стран страна странах 
экспорт: экспорта экспорт 
европа: европу европы европе 
повышать: повысило 
сырье: сырье сырья 
приходиться: приходилось придется пришлись 
нефтепродукт: нефтепродукты 
государственный: государственный государственные 
инвестиционный: инвестиционного инвестиционный инвестиционной 
мир: мире мира 
декабрь: декабря 
суммарный: суммарные 
актив: активы активов активами 
оцениваться: оценивались 
раз: раза 
расходный: расходной 
часть: часть части 
бюджет: бюджета бюджетом 
сопоставимый: сопоставимо 
великобритания: великобритании 
почему: почему 
получать: получить получать получили получает получил 
розничный: розничной розничным 
разбирать: разберем 
статья: статью статье статьи 
роман: роман 
романович: романович 
зарабатывать: заработал зарабатывает заработать зарабатывать 
профиль: профиль 
автор: автора автор 
источник: источник 
reuters: reuters 
владеть: владеет 
портфель: портфелями портфель портфеле портфелей портфели портфеля 
компания: компании компанией компаний компания 
число: числе числа 
среднее: среднем 
принадлежать: принадлежат принадлежит 
зарегистрировать: зарегистрированных 
мировой: мировых мировые 
биржа: биржах 
позиция: позиции позиция 
млн: млн 
apple: apple 
microsoft: microsoft 
alphabet: alphabet 
nestle: nestle 
доля: доля доли долю 
рыночный: рыночная 
стоимость: стоимость стоимости 
российский: российских российские 
сбербанк: сбербанк 
norges: norges 
bank: bank 
investment: investment 
management: management 
самый: самым самые самом самый 
вложение: вложения 
сша: сша 
япония: японии 
германия: германии 
вкладывать: вложили 
состав: составе 
корпоративный: корпоративных 
бумага: бумаги 
america: america 
объект: объектов объектами объекте 
индустриальный: индустриальных 
складской: складских 
комплекс: комплексов 
офисный: офисных 
центр: центров 
торговый: торговых 
жилой: жилых 
сдача: сдачи 
аренда: аренду 
правило: правило правилам правила 
входить: входит 
партнерство: партнерстве 
специализированный: специализированной 
средний: средняя среднюю 
участие: участия 
партнер: партнер 
американский: американская 
prologis: prologis 
оператор: оператор оператором 
инфраструктура: инфраструктура 
начинать: начнут начал 
инфраструктурный: инфраструктурные 
проект: проекте проект проекта проекты 
зеленый: зеленой 
энергетика: энергетике 
пока: пока 
реализовывать: реализован 
морской: морская 
ветряной: ветряных ветряная 
электростанция: электростанций электростанция 
borssele: borssele 
километр: километрах 
нидерланды: нидерландов 
совместно: совместно 
датский: датской 
курс: курсе курс 
общаться: общаться 
понимать: понимать поняла 
друг: друг друга 
бесплатный: бесплатный 
бережно: бережно 
окружающий: окружающими 
часто: чаще 
желать: желаемое 
изучать: изучить 
смог: смог 
комментарий: комментарии комментариях 
управлять: управляющих 
главный: главными главная 
такой: такие таких такого 
указывать: указаны 
геополитический: геополитическая 
напряженность: напряженность 
высокий: высокая высоком 
инфляция: инфляции инфляцию инфляция инфляцией 
расти: растущий расти растущие растет 
процентный: процентные процентных 
ставка: ставок ставки 
этот: эта 
комбинация: комбинация 
фактор: факторов 
негативно: негативно 
сказываться: сказалась 
рынок: рынок рынкам рынки рынков рынке рынка 
конец: конец 
структура: структура 
выглядеть: выглядела 
фиксированный: фиксированных 
область: области 
возобновлять: возобновляемой 
энергетик: энергетики 
классический: классических классический классического 
показывать: показали показал 
снижение: снижения снижение 
плохой: худшую худшие 
использовать: использовали использовать 
соотношение: соотношение 
качество: качестве 
ориентир: ориентира 
распределение: распределения 
десятилетие: десятилетиями 
данный: данным 
blackrock: blackrock 
среднегодовой: среднегодовая 
годовой: годовых 
период: периоды период 
подобный: подобные подобный 
подход: подходу подходом подход 
позволять: позволить позволял позволяет позволило 
рост: росту роста рост 
счет: счет счетах 
сильный: сильного сильным 
слабый: слабому слабой 
динамика: динамики 
момент: моменты 
финансовый: финансовых финансового финансовый 
кризис: кризиса кризисов 
больший: большая 
поддерживать: поддерживать поддерживала 
большой: больших большой 
потеря: потерь 
падение: падение падении падению падением падения 
например: например 
упасть: упал упали 
мало: меньше 
сравнение: сравнении 
зафиксировать: зафиксировал 
механика: механика 
рухнуть: рухнула 
одновременно: одновременно 
ударять: ударил 
financial: financial 
times: times 
amazon: amazon 
meta: meta 
platforms: platforms 
tesla: tesla 
опасение: опасений 
рецессия: рецессии 
который: который которой которые которых которая 
ухудшать: ухудшит 
потребительский: потребительскую 
активность: активность 
снижать: снизит 
фон: фоне 
замедление: замедления 
активный: активных активной 
пользователь: пользователей 
социальный: социальных 
сеть: сети сетей 
рекламный: рекламных 
неоправданный: неоправданных 
ожидание: ожиданий 
метавселенная: метавселенной 
проблема: проблем проблемы проблема проблеме 
автомобиль: автомобилей 
китай: китае китай китая 
закрытие: закрытия 
завод: завода 
шанхай: шанхае 
весна: весной 
карантинный: карантинных 
ограничение: ограничений 
организация: организация организации 
деятельность: деятельность деятельности 
признавать: признана 
экстремистский: экстремистской 
запрещать: запрещена 
территория: территории 
рф: рф 
слово: словам 
глава: главы 
николай: николая 
танген: тангена танген 
ситуация: ситуация 
изменяться: изменится 
хороший: лучшую лучшие 
сторона: сторону стороны 
думать: думаю 
неопределенность: неопределенности 
связанный: связана 
происходить: происходящего произойдет 
глобальный: глобальных глобальную глобального глобальной 
дело: дело 
вступать: вступит 
центробанк: центробанки 
подымать: поднимают 
сдерживать: сдержать 
спрятаться: спрятаться 
негде: негде 
сказать: сказал 
интервью: интервью 
bloomberg: bloomberg 
tv: tv 
второй: вторая второе 
экономика: экономик экономику экономики экономика 
ввп: ввп 
третий: третья 
импорт: импорта 
европейский: европейский европейского 
союз: союза 
отмена: отмена 
коронавирусный: коронавирусных 
стимулирование: стимулирование 
приводить: приведет 
потребление: потребления 
спрос: спроса спрос 
промышленный: промышленные 
товар: товары 
уровень: уровне уровень 
осложнять: осложнит 
борьба: борьбу 
стимулировать: стимулировать 
разгонять: разогнать 
цена: цен цене 
проходить: проходят прошедший 
оказываться: оказался 
сложный: сложным 
индустрия: индустрии 
управление: управлении управления 
preqin: preqin 
становиться: стать стал стало 
citadel: citadel 
wellington: wellington 
fund: fund 
прибыль: прибыли 
bridgewater: bridgewater 
рэй: рэя 
далио: далио 
добиваться: добиться добиваются 
агрессивный: агрессивному агрессивные 
стратегия: стратегию стратегия стратегии 
подходить: подходят 
пенсионный: пенсионных 
национальный: национального национальные 
протяжение: протяжении 
держать: держал держи 
фондовый: фондовый 
light: light 
street: street 
capital: capital 
технологический: технологических 
преобладать: преобладали 
мочь: могут 
риск: риск риски 
пример: примера 
обращать: обратил 
внимание: внимание 
йельский: йельского 
университет: университета университетов 
финансироваться: финансируется 
жизнь: жизнь 
научный: научной научная 
поэтому: поэтому 
управляющий: управляющим управляющие 
слишком: слишком 
некоммерческий: некоммерческой 
сформировывать: сформирован 
пожертвование: пожертвований 
использоваться: используется 
целевой: целевому целевых 
случай: случае 
тратиться: тратятся 
выплата: выплату 
зарплата: зарплатой зарплаты 
сотрудник: сотрудникам 
стипендия: стипендий 
студент: студентам 
финансирование: финансирование 
октябрь: октябре 
опубликовывать: опубликовал 
отчет: отчета отчет 
заканчиваться: закончившийся 
июнь: июня 
июль: июля 
индекс: индекс 
снижаться: снизился снизилась 
широкий: широкой 
диверсификация: диверсификации диверсификация 
предел: пределами 
начало: начале 
частный: частные частный 
чей: чьи 
торговаться: торгуются 
участвовать: участвует 
венчурный: венчурных 
перспективный: перспективные 
стартапа: стартапы 
трансформация: трансформации 
обязанный: обязан 
дэвид: дэвиду 
свенсон: свенсону 
йель: йеле 
свой: свои своим своей своего 
смерть: смерти 
май: мае 
превышать: превышает 
эндаумент: эндаумент эндаументов 
аналогичный: аналогичный 
единственный: единственным 
среди: среди 
лига: лиги 
плющ: плюща 
положительный: положительную 
занимать: занимает 
место: место мест 
объем: объему 
первый: первое 
гарвард: гарварда 
делать: делать 
амин: амина 
раджан: раджана 
исполнительный: исполнительного 
директор: директора директор 
create: create 
research: research 
рано: раньше 
получение: получения 
нужно: нужно 
сконцентрироваться: сконцентрироваться 
краткосрочный: краткосрочных краткосрочной 
перспектива: перспективе 
изобретательный: изобретательными 
отходить: отойти 
шаблонный: шаблонных 
согласный: согласны 
мнение: мнению мнение 
повышенный: повышенной 
выходить: выйти 
рамка: рамки 
гибкий: гибкими 
разнообразить: разнообразить 
привязка: привязкой 
фокус: фокуса 
региональный: региональные 
развивающийся: развивающихся 
возможный: возможного 
решение: решения 
предлагать: предлагают 
ротация: ротации ротацией 
класс: классами классов 
внутри: внутри 
внимательно: внимательно 
следить: следить 
показатель: показателями 
корреляция: корреляции 
взгляд: взгляд 
задача: задача 
разный: разных 
находиться: находящихся 
стадия: стадией стадиях 
экономический: экономического 
цикл: цикла 
возможность: возможности 
независимый: независимых 
отдельный: отдельной 
помощь: помощью 
ежеквартальный: ежеквартального 
fidelity: fidelity 
уделять: уделить 
длинный: длинным длинными 
короткий: короткими 
срок: срок сроком 
погашение: погашения 
падать: падают 
сильно: сильнее 
обезопасить: обезопасить 
сохранять: сохранит 
денежный: денежный 
продолжать: продолжит 
поступать: поступать 
готовиться: готовиться 
понижение: понижению 
долгосрочный: долгосрочных 
этап: этапе 
быть: будут 
быстро: быстрее 
новость: новости 
касаться: касаются 
наш: нашем 
подписываться: подписывайтесь 
тэг: тэги 
валюта: валюта 
фотография: фотография 
обложка: обложке 
andrzej: andrzej 
rostek: rostek 
istock: istock 
предпринимать: предпринимаете 
улучшение: улучшения 
модерация: модерацию 
журнал: журнала 
даурен: даурен 
необходимый: необходима 
отвечать: ответить 
наталия: наталия 
мехедов: мехедова 
герой: герой 
спасибо: спасибо 
обзор: обзор 
интересно: интересно 
узнавать: узнать 
подробно: подробнее 
инвестица: инвестиц 
ссылка: ссылкам 
хотеть: хотят хочет 
делиться: делиться делятся 
информация: информацией 
вообще: вообще 
неохотно: неохотно 
уточнять: уточню 
редакция: редакции 
взять: возьмем 
тема: тему 
andre: andre 
macareno: macareno 
вроде: вроде 
списывать: списал 
еще: ещё 
учитывать: учтено 
список: списке 
ненулевой: ненулевая 
мошенник: мошенникам 
понадобиться: понадобились 
справка: справки 
репетитор: репетитор 
полагаться: полагался 
каникулы: каникулы 
платить: платил 
налог: налог налоги 
человек: человеку человек 
инвалидность: инвалидностью 
копить: копить 
покупать: покупать 
балл: баллы 
уведомлять: уведомлять 
белоруссия: белоруссии 
работник: работник 
поставлять: поставлять поставить 
работодатель: работодателю 
ипать: ип 
молодой: молодой 
оформлять: оформить 
машина: машину 
сотрудничать: сотрудничают 
иностранный: иностранным 
сосед: соседи 
заливать: залили 
дверной: дверную 
ручка: ручку 
замок: замок 
клей: клеем 
протест: протест 
ремонт: ремонта 
завещание: завещание 
ребенок: дети детей 
муж: мужа 
имущество: имущество 
здание: здание 
баланс: баланс 
рассказывать: расскажите 
багаж: багажом 
возникать: возникали 
поездка: поездках 
косметичка: косметичка 
уход: уход 
чувствительный: чувствительной 
комбинированный: комбинированной 
кожа: кожей 
акна: акне 
покупатель: покупателя 
продавец: продавец 
вносить: внесет 
сколько: сколько 
вернуть: вернуть 
обучение: обучение 
отрабатывать: отработала 
договор: договор договору 
процент: проценты 
популярный: популярное 
неделя: неделю 
посылка: посылка 
застревать: застряла 
таможня: таможне 
стаут: стауты 
гоза: гозе 
ламбик: ламбики 
пить: пить 
крафтовый: крафтовое 
пиво: пиво 
москва: москве 
жить: живет 
бали: бали 
въезд: въезда 
сербия: сербию 
россиянин: россиян 
поколение: поколение 
девяностый: девяностых 
лишний: лишнее 
труд: труда 
беспроводный: беспроводные 
колонка: колонки 
удачный: удачных 
модель: моделей 
поволжье: поволжье 
экономист: экономист 
дежурный: дежурный 
электромонтер: электромонтер 
новосибирск: новосибирске 
несколько: несколько 
тратить: тратила 
классный: классные 
впечатление: впечатления 
watch: watch 
вакансия: вакансии 
сообщать: сообщить 
контакт: контакты 
политика: политика 
конфиденциальность: конфиденциальности 
пользование: пользования 
сайт: сайтом 
ао: ао 
банк: банк 
лицензия: лицензия 
