хороший: лучшие лучших хорошие хорошее хороши лучшая 
apple: apple 
watch: watch 
год: год году лет года годом 
обзор: обзоров обзор обзоры 
series: series 
se: se 
характеристика: характеристики 
дизайн: дизайн 
ремешок: ремешками ремешком ремешок ремешков 
автономность: автономность автономности 
цена: цены цена 
промой: промо 
бесплатный: бесплатная 
кредитка: кредитка 
промокод: промокоду 
fgo: fgo 
давать: давайте 
учебник: учебник 
сравнятор: сравнятор 
сообщество: сообщество 
ипотека: ипотека 
кредитный: кредитная 
история: история 
тест: тестов тест тесты 
дневник: дневники дневник 
трата: трат 
налоговый: налоговые налоговую налоговый 
вычет: вычет 
написать: написать 
инвестиция: инвестиции 
бизнес: бизнес бизнеса 
разбор: разборы 
закон: законов 
калькулятор: калькуляторы калькуляторе 
путешествие: путешествиях путешествия 
медицина: медицина 
здоровье: здоровье здоровья 
недвижимость: недвижимость 
подкаста: подкасты 
видео: видео 
смотреть: смотреть смотрите 
сервис: сервисы 
расчет: расчеты 
закладка: закладки 
письмо: письма 
оставаться: остаться оставались оставайтесь 
деньги: деньгами деньги денег 
поток: потоки 
какой: какие 
модель: моделям моделей моделями модель модели моделях 
продажа: продажи продаже 
выбирать: выбрал выбрать 
никита: никита 
богуславский: богуславский 
любить: любит 
часы: часы часах 
быстрый: быстрой быструю быстрая быстрый 
зарядка: зарядки зарядку зарядке зарядкой зарядка 
профиль: профиль 
автор: автора авторы 
январь: январе января 
продавать: продает продал 
актуальный: актуальные актуальных актуальными актуальная 
час: часами час часов часа 
магазин: магазинах магазин 
доступно: доступно 
намного: намного 
вариант: вариантов вариант 
внимательно: внимательно 
следить: слежу следить следят 
рынок: рынком рынке 
гаджет: гаджетов 
семь: семь 
самостоятельно: самостоятельно 
тестировать: тестирую 
практически: практически 
интересный: интересные 
умный: умные умными умных 
целое: целом 
исключение: исключение 
пользоваться: пользоваться пользуюсь пользовался пользуется 
многий: многими 
сравнивать: сравнивал 
аналог: аналогами 
другой: другому других другим другое другими другая другую 
производитель: производителей производителя 
делать: делать делает делают 
владелец: владельца владелец владельцев 
айфон: айфоне айфонов айфоном айфона 
удобно: удобнее удобно 
любой: любой любых 
управление: управление управления 
музыка: музыку музыкой 
чтение: чтения 
уведомление: уведомлении уведомления уведомлений 
навигация: навигации 
базовый: базовыми базовых 
тренировка: тренировок тренировки 
идеально: идеально 
вписывать: вписаны 
экосистема: экосистему экосистемы 
бренд: бренда 
никакой: никакое никакие никакой никакого 
универсальный: универсальное универсальные 
устройство: устройство устройств 
c: c 
они: ними ими 
сравниться: сравнится 
статья: статье 
рассказывать: расскажу расскажите 
различаться: различаются 
помогать: помогают помочь помогу 
определяться: определиться 
выбор: выбором выборе выбор 
богатеть: богатеть 
главный: главная главные 
материал: материала материалы 
обо: обо 
все: всеми всем всё 
влиять: влияет 
ваш: вашей ваши ваш 
жизнь: жизни жизнь 
почта: почте 
среда: средам 
суббота: субботам 
бесплатно: бесплатно 
подписываться: подписаться подписывайтесь 
наш: наши нашем наших 
рекомендация: рекомендации 
самый: самые самое самом самых 
наворотить: навороченные 
ultra: ultra 
новый: новыми новом новее новые новых новой новая 
большой: большим большую большой большие 
дисплей: дисплея дисплей дисплеем 
нужный: нужном нужными нужна нужны 
сенсор: сенсорами сенсоров 
вроде: вроде 
измерение: измерения 
кислород: кислорода 
экг: экг 
огромный: огромные 
защищать: защищенные 
корпус: корпус корпусе корпусом 
титан: титана 
прочный: прочные прочным 
стекло: стеклом стекло 
подходить: подойдут подойдет подходят 
массивный: массивные 
аксессуар: аксессуары аксессуар 
р: р 
доступный: доступные 
компактный: компактные 
возможность: возможностями возможностей 
стоять: стоят стоит 
сравнительно: сравнительно 
недорого: недорого 
подарок: подарком подарок 
пожилой: пожилая пожилым пожилых 
родственник: родственникам 
получать: получить получим получать получила получили 
комиссия: комиссию 
покупка: покупки покупку 
товар: товаров товары 
искажать: искажаем 
приукрашивать: приукрашиваем 
конкретный: конкретной конкретных 
вещь: вещи вещей вещь 
зависеть: зависит 
тинькофф: тинькофф 
журнал: журнала журнале 
независимый: независимы 
выносить: выносим 
вердикт: вердикт 
основа: основе 
который: который которая которые которых 
тщательно: тщательно 
изучать: изучаем изучили 
показывать: показали показало показать 
время: время времени 
редакционный: редакционных 
либо: либо 
запрашивать: запрашиваем 
закупать: закупаем 
сам: само сами 
рецензия: рецензии 
издание: изданиях 
мнение: мнения мнение 
пользователь: пользователей 
отзыв: отзывы 
субъективный: субъективные 
честный: честные 
экспертный: экспертные 
писать: пишут 
плечо: плечами 
команда: команда 
редактор: редакторов 
перепроверять: перепроверяет 
текст: тексты 
вычитывать: вычитывает 
проводить: проводит 
фактчекинг: фактчекинг 
указывать: указаны 
момент: момент 
выход: выхода выходом 
периодически: периодически 
обновлять: обновляем 
официально: официально 
снимать: снять снимаешь сняты снимать 
равно: равно 
ряд: ряду 
причина: причинам причин 
экран: экраны экранов экраном экрану экран экрана 
процессор: процессоре процессор процессорах 
большинство: большинство большинстве 
функция: функции функция функций 
этот: эта этих 
одинаковый: одинаковы одинаковых 
добавлять: добавить добавили добавляет 
опция: опции 
датчик: датчиков датчика датчик 
автокатастрофа: автокатастроф 
термометр: термометр 
измерять: измерять измерить измеряет 
температура: температурах температуры температуру 
тело: тела 
полноценный: полноценно 
лишь: лишь 
относительный: относительные относительной 
изменение: изменения 
заметно: заметно 
дорогой: дорогой дорогих дорогие дороже 
рациональный: рациональный 
оптимальный: оптимальный 
выпускать: выпускать выпускают выпустила 
два: двух 
размер: размере размерах размеров 
мм: мм 
разница: разницы разница 
ощутимый: ощутимая 
больший: большем большая 
версия: версии версия 
показываться: показаться 
крупноватый: крупноватой 
некоторые: некоторых 
мужчина: мужчин 
сходить: сходить 
примеривать: примерить 
совместимый: совместимы 
старый: старые старых старым 
браслет: браслетов браслеты 
удачный: удачных 
фишка: фишка 
яркий: яркий 
минимальный: минимальное минимальными 
рамка: рамки рамками 
кажется: кажется 
картинка: картинка 
растекаться: растекается 
край: края краям 
ради: ради 
немного: немного 
увеличивать: увеличили увеличат 
сравнение: сравнению сравнении 
зато: зато 
помещаться: помещается 
четверть: четверть 
информация: информации информацию 
незначительно: незначительно 
отличаться: отличается 
просмотр: просмотр 
отзывчивость: отзывчивость 
элемент: элементов 
интерфейс: интерфейс интерфейса 
очень: очень 
плавный: плавные 
срабатывать: срабатывают 
задержка: задержки 
доставаться: достались 
прошлый: прошлых 
поколение: поколений поколения поколение поколениями 
многие: многие 
полезный: полезные 
например: например 
высота: высоту 
реальный: реальном 
сделать: сделать 
один: одному одном одна одним одно 
касание: касанию 
узнавать: узнать 
уровень: уровень 
кровь: крови 
благодаря: благодаря 
эволюция: эволюции 
устанавливать: установлены 
также: также 
мочь: могу могут 
пульс: пульс 
уведомлять: уведомлять 
низкий: низком 
повышенный: повышенном 
сердечный: сердечном 
ритм: ритме 
обнаруживать: обнаруживать 
нерегулярный: нерегулярное 
сердцебиение: сердцебиение 
фиксировать: фиксировать 
падение: падения падение падений 
отслеживать: отслеживать отслеживали 
сон: сна сон сном 
поддерживать: поддерживает поддерживают 
включать: включенный включенного включенным включить 
режим: режиме режим режимом 
обычно: обычно 
черный: черный 
загораться: загорается 
ответ: ответа ответ 
движение: движений движение 
запястье: запястья 
последний: последних последние последнюю 
постоянный: постоянного постоянное 
отображение: отображение 
циферблат: циферблат циферблата 
рука: руке 
выглядеть: выглядели выглядит выглядят 
эстетичный: эстетичнее эстетичными 
посмотреть: посмотреть 
лишний: лишних лишнее 
работать: работает работают работать работал работало 
улучшать: улучшить 
полный: полную полным 
набор: набором набор 
жить: живут живет 
примерно: примерно 
сутки: суток сутки 
позволять: позволяют позволяет позволить 
гаснуть: гаснуть 
день: дня днем день дней 
начинать: начиная 
комплектный: комплектный 
провод: провод 
usb: usb 
заряжаться: заряжаются заряжаться 
минута: минут 
требоваться: требуется 
полтора: полтора полутора 
быстро: быстрее быстро 
утро: утром 
получаться: получится 
сколько: сколько 
альтернатива: альтернатива 
поэтому: поэтому 
просто: просто проще 
находить: найти 
цвет: цвету цвете цвета 
синий: синие синей 
зеленый: зеленой 
расцветка: расцветки 
появляться: появится появилась появился появившийся 
серебристый: серебристым серебристый серебристом серебристая 
звезда: звезда 
оттенок: оттенка 
россия: россии 
автоматический: автоматический автоматическом 
вызов: вызов 
экстренный: экстренных 
служба: служб службами 
покидать: покинула 
страна: страну странах 
нововведение: нововведение 
это: это 
смочь: сможет 
дома: дома 
определять: определяет 
колебание: колебания 
течение: течение 
пока: пока 
использоваться: используется 
отслеживание: отслеживания отслеживание 
женский: женского 
определение: определения 
фаза: фаз 
цикл: цикла 
планирование: планировании 
беременность: беременности 
необходимо: необходимо 
носить: ношу носить 
каждый: каждой каждый 
постоянно: постоянно 
ночь: ночь ночью 
иначе: иначе 
зарабатывать: заработает 
предназначать: предназначенные 
путешественник: путешественников 
покупать: покупать покупайте покупал покупают 
солидно: солидно 
спутывать: спутаешь 
титановый: титановым 
плоский: плоским плоский 
тяжелый: тяжелые 
органично: органично 
смотреться: смотрятся 
одежда: одеждой 
скругленный: скругленный 
остальной: остальных 
трудно: труднее трудно 
разбивать: разбить 
поцарапать: поцарапать 
наклеивать: наклеить 
защитный: защитное 
солнце: солнце 
яркость: яркость 
подниматься: подниматься 
нит: нит 
высоко: выше высоко 
легко: легко 
увидеть: увидят увидеть 
направление: направление 
гора: горах 
серфинг: серфинг серфинга 
пустыня: пустыне 
выходить: вышел выйти выхожу выходить 
ребята: ребят 
хотеться: хочется 
себя: собой 
везде: везде 
выдерживать: выдерживают 
погружение: погружение 
глубина: глубину 
м: м 
продержаться: продержаться 
заряд: заряде заряда заряд 
энергосбережение: энергосбережения 
нормальный: нормальном 
дополнительный: дополнительная 
кнопка: кнопка 
оранжевый: оранжевая 
назначать: назначить 
запуск: запуск 
действие: действие 
сохранение: сохранения 
местоположение: местоположения 
gps: gps 
повседневный: повседневной 
городской: городской 
бесполезный: бесполезна 
нацеливать: нацелены 
безопасность: безопасность 
спутниковый: спутниковая 
антенна: антенна 
передавать: передавать 
сигнал: сигнал 
sos: sos 
точный: точные 
координата: координаты 
спасатель: спасателям 
потеряться: потерялся 
потерпеть: потерпел 
кораблекрушение: кораблекрушение 
сша: сша 
несколько: несколько нескольких 
договариваться: договорилась 
местный: местными 
встраивать: встроен 
громкий: громкий 
динамик: динамик 
использовать: использую использовать 
сирена: сирену 
тестирование: тестирование 
обычный: обычной обычном обычный 
свисток: свисток 
лес: лесу 
слышно: слышно 
расстояние: расстоянии 
повторять: повторяйте повторяют 
идея: идею 
iphone: iphone 
мало: поменьше 
дешево: подешевле 
номерной: номерная 
начинка: начинкой 
три: трех 
цветок: цветов цветах 
золотистый: золотистом 
полностью: полностью 
соответствовать: соответствующих 
предусматривать: предусмотрен 
глонасс: глонасс 
пробежка: пробежек пробежку пробежки 
электронный: электронный 
компас: компас 
зарегистрировать: зарегистрируют 
спрашивать: спросят 
помощь: помощь помощью 
долгий: долгого 
отправлять: отправят 
сообщение: сообщение 
полезно: полезно 
человек: людей люди человеку человек 
хватать: хватает 
поддержка: поддержка поддержки 
подключать: подключать подключенную 
розетка: розетке 
обед: обед 
вечер: вечером 
подборка: подборки 
взять: взяли взять взял 
пролистываться: пролистывается 
плавно: плавно 
случай: случаев 
прибавка: прибавка 
производительность: производительность производительности 
играть: играет 
особый: особой особое 
роль: роли 
критерий: критерии 
отбор: отбора 
бросаться: бросается 
глаз: глаза 
первый: первых первая первую первый 
очередь: очередь 
именно: именно 
приходиться: приходится придется пришлось 
иметь: иметь 
дело: дело 
отдельный: отдельными отдельных 
проживать: прожить 
замечать: заметить замечаю 
вид: вид виду 
нужно: нужно 
уделять: уделить 
внимание: внимание 
много: побольше 
aod: aod 
активный: активный 
прямоугольник: прямоугольник 
бюджетный: бюджетных 
простой: попроще 
немой: нем 
видно: видно 
нормально: нормально 
разглядеть: разглядеть 
пульсоксиметр: пульсоксиметром 
важный: важен важное 
рассчитать: рассчитаны 
потребление: потребление 
контент: контента 
ресурсоемкий: ресурсоемкие 
задача: задачи 
приложение: приложение приложений приложения 
дополнять: дополняют 
опыт: опыт опыту 
использование: использованию использования 
смартфон: смартфоне смартфона 
связка: связке 
комфорт: комфорт 
мощность: мощности 
чип: чип 
медленно: медленнее 
подтормаживать: подтормаживать 
регулярно: регулярно 
заряжать: зарядив заряжать заряжал 
редко: реже 
отключать: отключить 
часть: часть 
поддерживаться: поддерживается 
аккумулятор: аккумулятор 
заполняться: заполняется 
раз: раза 
кабель: кабеля 
работа: работу работы 
против: против 
спорт: спортом спорт спорта 
популярный: популярным популярное популярных 
показатель: показателей показателями 
активность: активность активности активностей 
система: систему системой 
кольцо: колец 
очки: очками очки 
буквально: буквально 
заставлять: заставляют 
заниматься: заниматься занимаюсь 
гулять: гулять 
особенно: особенно 
друг: друзей 
видеть: вижу видеть 
успех: успехи 
постить: постим 
кружочек: кружочки 
красивый: красивые 
карточка: карточки 
новость: новости 
технология: технологиях 
классно: классно 
тэг: тэги 
техника: техника 
обложка: обложка 
хотеть: хотели хочет хотим хочу 
купить: купил купила купить купленный 
комментарий: комментарии 
проходить: проходят 
модерация: модерацию 
правило: правилам правила 
jane: jane 
герой: герой 
garmin: garmin 
отвечать: ответить 
lazex: lazex 
отредактировать: отредактировано 
гармин: гармины гарминов 
неплохой: неплохи 
довольно: довольно 
специфичный: специфичны 
глубокий: глубокой 
интеграция: интеграции 
общий: общего общую 
принцип: принципе 
странный: странное 
пора: пор пора порой 
серия: серии серией сериями 
fenix: fenix 
вообще: вообще 
отсутствовать: отсутствует 
тачскрин: тачскрин 
скудный: скудный 
appstore: appstore 
google: google 
play: play 
надевать: надевать 
поход: поход 
типичный: типичному типичного 
житель: жителю 
мегаполис: мегаполиса 
громоздкий: громоздки 
излишний: излишни 
мой: моих мое моего мои моим 
имхо: имхо 
такой: такие таком такими таким 
натуральный: натуральный 
маркетинг: маркетинга маркетинг 
телефон: телефона телефон телефоном телефоне 
компромисс: компромисс 
sanye: sanye 
west: west 
ес: ес 
ита: ит 
пересаживаться: пересел 
нравиться: нравится нравятся 
внешне: внешне 
alexander: alexander 
marq: marq 
adventurer: adventurer 
denis: denis 
akatov: akatov 
решать: решал решил 
esim: esim 
реклама: рекламе 
эпл: эпл 
приходить: приходили 
звонок: звонки 
интернет: интернет 
bmo: bmo 
впечатление: впечатления 
смешанный: смешанные 
сила: силы 
будильник: будильника будильник 
погода: погода 
курсы: курсы 
валюта: валют 
количество: количество 
красиво: красиво 
синхронизироваться: синхронизируется 
жутко: жутко 
бесить: бесит 
тупо: тупо 
ждать: жду ждать 
хотя: хотя 
неделя: недели неделю недель 
рано: раньше 
ходить: ходил хожу 
miband: miband 
месяц: месяц 
обратно: обратно 
переходить: перейти 
амазфит: амазфит 
бип: бип 
прямо: прямо 
реально: реально 
втыкать: воткнуть втыкают 
сеть: сети сеть 
вставлять: вставить 
домой: домой 
улица: улицы 
кинуть: кинул 
глядеть: глядя 
беспроводный: беспроводные беспроводную 
магнитный: магнитную 
забывать: забыть забыл 
основной: основной основных 
сценарий: сценариев сценарий сценариями 
трекер: трекер 
подзаряжать: подзаряжать подзарядить 
знать: знал знающие знаю 
кто: кому 
напрягать: напрягает 
юрий: юрий 
приучать: приучить 
утренний: утренними 
процедура: процедурами 
чистить: чистишь 
зуб: зубы 
бриться: бреешься 
принимать: принимаешь 
душ: душ 
поставлять: поставлять поставить 
готовый: готовый 
девайс: девайс 
ион: ион 
тихий: тихий 
вступаться: вступлюсь 
защита: защиту 
bip: bip 
прижим: прижим 
контакт: контактам контакта контакты 
прищепок: прищепки 
трижды: трижды 
уезжать: уезжал 
отпуск: отпуск 
недостаток: недостаток 
думать: думаешь 
проблема: проблемы проблему проблема проблеме 
отрезать: отрезанным 
прижимать: прижатыми 
скотч: скотчем 
проводок: проводками 
соглашаться: соглашусь 
решение: решением решений 
малый: малой 
должный: должны 
менее: менее 
д: д 
полтзоваться: полтзовался 
около: около 
легкий: легким 
чувство: чувством 
разочарование: разочарования 
прекрасный: прекрасная 
синхронизация: синхронизация 
герметичность: герметичность 
легкость: легкость 
понравиться: понравилось 
часто: чаще 
состояние: состояние 
бесполезность: бесполезность 
круг: кругов круги 
спустя: спустя 
обилие: обилия 
kpi: kpi 
становиться: становится стали стал 
пофиг: пофиг 
отвлекать: отвлекают 
ощупь: ощупь 
дешевый: дешевые 
царапаться: царапаются 
плохой: плохая 
статистика: статистика 
число: числа 
усеченный: усеченные 
график: графики 
неинтересно: неинтересно 
свой: своим своих 
прогресс: прогрессом 
вполне: вполне 
недорогой: недорогой 
спортсмен: спортсменов 
гениальный: гениальны 
туман: туман 
рассеиваться: рассеивается 
пара: пару 
ракета: ракета 
отличие: отличий 
кроме: кроме 
занятие: занятий 
напоминать: напоминают 
сидеть: сижу 
прогуливаться: прогуляться 
держать: держи держат 
бодро: бодрей 
действительно: действительно 
загадка: загадка 
алексей: алексей 
ливанов: ливанов 
константин: константин 
чегем: чегемов 
еще: ещё 
точка: точка 
весь: весь 
мир: мир 
слово: слов 
уменьшать: уменьшить 
oleg: oleg 
frantsuzov: frantsuzov 
курс: курсе 
ребенок: детей дети 
watchos: watchos 
настройка: настроек настройки настройка 
член: членам члена 
семья: семьи 
семейный: семейной 
активировать: активировать 
продаваться: продаются 
абзац: абзац 
неактуальный: неактуален 
дезинформировать: дезинформирует 
потенциальный: потенциальных 
покупатель: покупателей покупателя 
подробно: подробнее 
тьфунатебать: тьфунатебя 
попробовать: попробую 
объяснять: объяснить 
понимать: понимаю 
поправлять: поправят 
правда: правда 
давно: давно 
симкарта: симкарта 
дублироваться: дублировалась 
законодательно: законодательно 
запрещать: запрещен 
дубликат: дубликат 
подвижка: подвижек 
план: плане 
ведомство: ведомств 
тип: типа 
минцифра: минцифры 
sun: sun 
отличный: отличная 
жаль: жаль 
скоро: скоро 
обновление: обновления обновлений 
переставать: перестанут перестало 
запас: запас 
прочность: прочности 
дата: дату дата 
неудобно: неудобно 
долго: долго 
скидка: скидкой 
пятница: пятницу 
отлично: отлично 
сменить: сменил 
разблокировка: разблокировка 
face: face 
id: id 
маска: маске 
вводить: вводить 
пин: пин 
крайне: крайне 
абсолютный: абсолютному 
минимум: минимуму минимум 
попросить: попросить 
сиря: сири 
таймер: таймер 
посчитать: посчитать 
бывать: бывает 
календарь: календарь 
будить: будят 
вибрация: вибрацией 
пищать: пищат 
жена: жены жена 
просыпаться: просыпается 
ошибка: ошибок 
позапрошлый: позапрошлом 
замаяться: замаялся 
фиг: фиг 
классика: классика 
серый: серый 
ezdiumno: ezdiumno 
жикушор: жикушор 
глупо: глупо 
называть: называть 
лошар: лошарами 
иной: иное 
вопрос: вопрос 
предпочтение: предпочтения 
автомобиль: автомобиля 
ferrari: ferrari 
уаз: уаз 
возить: возить 
картошка: картошку 
дача: дачи 
тск: тск 
китайский: китайский 
кварц: кварц 
руб: руб 
счастие: счастье 
швейцарский: швейцарская 
механика: механика 
миллион: миллион 
повседневность: повседневность 
aw: aw 
sgw: sgw 
huawei: huawei 
gt: gt 
runner: runner 
amazfit: amazfit 
gts: gts 
sony: sony 
sw: sw 
лох: лохами лох 
чужой: чужой 
уважать: уважает 
объем: объем 
память: памяти 
занимать: занята 
присылать: присылая присылают 
требовать: требует 
свободный: свободного 
место: место места мест 
однажды: однажды 
сбросить: сбросить 
заводской: заводских 
освобождать: освободить 
обновляться: обновиться 
брать: брать 
омрачаться: омрачается 
заново: заново 
закидывать: закидывать 
забивать: забил 
бегать: бегал 
второй: вторая вторыми второго 
слабый: слабая 
тормоз: тормозах 
прощать: простить 
running: running 
club: club 
труд: труда трудом 
запускаться: запускалось 
пробовать: пробовал 
переустанавливать: переустанавливать 
сбрасывать: сбрасывать 
трекинг: трекинга 
горнолыжный: горнолыжных 
странно: странно 
ранее: ранее 
катание: катания 
сохранять: сохранило 
явно: явно 
устаревать: устарели 
сильно: сильно 
производительный: производительнее 
потребность: потребности потребностям 
перекрывать: перекрывают 
fitness: fitness 
просматривать: просматривал 
оказываться: оказалось 
важно: важно 
зависимость: зависимости 
внешний: внешний 
вкус: вкус 
прекрасно: прекрасно 
неудивительный: неудивительно 
коза: козе 
понятно: понятно 
ii: ii 
вместо: вместо 
coros: coros 
suunto: suunto 
разбитной: разбитная 
разведенка: разведенка 
hermes: hermes 
хах: хаха 
стальной: стальной стальные 
допы: доп 
прикольно: прикольно 
легенда: легенда 
поменять: поменять 
зараза: заразы 
замерять: замеряют 
платить: платил платят 
vladimir: vladimir 
sergeev: sergeev 
недавно: недавно 
активно: активно 
профессионально: профессионально 
считать: считаю 
старье: старье 
подкапливать: подкопить 
тот: те 
задумываться: задумывался 
точно: точно 
способ: способ 
пригождаться: пригодится 
насколько: насколько 
украинский: украинскую 
симка: симку 
разрешать: разрешено 
наверное: наверное 
жизненно: жизненно 
ленивец: ленивцам 
тягость: тягость 
переадресация: переадресацию 
плюс: плюс плюсом 
разряд: разряда 
пусть: пусть 
георгий: георгий 
джеджей: джеджея 
следующий: следующие 
быть: будут 
максимально: максимально 
тупой: тупыми 
смысл: смысла 
пять: пять 
третий: третьей 
эксплуатировать: эксплуатировал 
катушка: катушку 
бежать: бегу 
сей: сих 
марафон: марафона 
выживать: выживают 
ультрамарафон: ультрамарафон 
дохнуть: дохнут 
плавать: плавал 
пресный: пресной 
вода: воде водой 
море: море моря 
желательно: желательно 
промывать: промыть 
высыхание: высыхания 
приглушать: приглушить 
минус: минус 
отсутствие: отсутствие 
расширенный: расширенного 
функционал: функционал функционала 
мерять: мерять 
интервальный: интервальные 
засекать: засекать 
темп: темп 
примерный: примерное 
восстановление: восстановления 
каденс: каденс 
ширина: ширину 
шаг: шага 
тд: тд 
программа: программе 
достойный: достойно 
трое: трое 
набирать: набирают 
расширять: расширенный 
спортивный: спортивный спортивные 
арсенал: арсенала 
полар: полары 
корос: коросы 
лена: лена 
полгода: полгода 
назад: назад 
финансовый: финансовых 
карп: карп 
измайлов: измайлов 
переплата: переплата 
отпадный: отпадные 
худить: худи 
отбивать: отбитых 
сапфировый: сапфировым 
мошенник: мошенникам 
понадобиться: понадобились 
справка: справки 
репетитор: репетитор 
полагаться: полагался 
каникулы: каникулы 
налог: налог налоги 
инвалидность: инвалидностью 
копить: копить 
балл: баллы 
счет: счет счетах 
белоруссия: белоруссии 
работник: работник 
работодатель: работодателю 
ипать: ип 
молодой: молодой 
оформлять: оформить 
машина: машину 
риск: риски 
сотрудничать: сотрудничают 
иностранный: иностранным 
сосед: соседи 
заливать: залили 
дверной: дверную 
ручка: ручку 
замок: замок 
клей: клеем 
протест: протест 
ремонт: ремонта 
завещание: завещание 
муж: мужа 
имущество: имущество 
стоимость: стоимости 
здание: здание 
баланс: баланс 
багаж: багажом 
возникать: возникали 
поездка: поездках 
косметичка: косметичка 
уход: уход 
чувствительный: чувствительной 
комбинированный: комбинированной 
кожа: кожей 
акна: акне 
последствие: последствия 
продавец: продавец 
вносить: внесет 
доля: доли 
вернуть: вернуть 
обучение: обучение 
отрабатывать: отработала 
срок: срок 
целевой: целевому 
договор: договор договору 
составлять: составить 
процент: проценты 
посылка: посылка 
застревать: застряла 
таможня: таможне 
стаут: стауты 
гоза: гозе 
ламбик: ламбики 
пить: пить 
крафтовый: крафтовое 
пиво: пиво 
москва: москве 
бали: бали 
зарплата: зарплатой 
въезд: въезда 
сербия: сербию 
россиянин: россиян 
девяностый: девяностых 
колонка: колонки 
директор: директор 
розничный: розничной 
поволжье: поволжье 
экономист: экономист 
дежурный: дежурный 
электромонтер: электромонтер 
новосибирск: новосибирске 
тратить: тратила 
классный: классные 
вакансия: вакансии 
сообщать: сообщить 
проект: проекте 
политика: политика 
конфиденциальность: конфиденциальности 
пользование: пользования 
сайт: сайтом 
ао: ао 
банк: банк 
лицензия: лицензия 
