тинькофф: тинькофф 
журнал: журнал 
учебник: учебник 
сравнятор: сравнятор 
сообщество: сообщество 
ипотека: ипотека ипотеке 
кредитный: кредитная 
история: история истории 
тест: тесты 
дневник: дневники дневник 
трата: трат 
налоговый: налоговый 
вычет: вычет вычеты 
написать: написать 
сервис: сервисы 
расчет: расчеты 
закладка: закладки 
письмо: письма 
оставаться: оставайтесь 
деньги: деньгами деньги 
поток: потоки 
инвестиция: инвестиции инвестициях 
бизнес: бизнес 
разбор: разборы 
закон: законов законы 
калькулятор: калькуляторы 
путешествие: путешествия 
медицина: медицина 
здоровье: здоровье 
недвижимость: недвижимость 
подкаста: подкасты 
видео: видео 
смотреть: смотреть 
рассылка: рассылки 
выбирать: выбрать 
интересный: интересные 
тема: темы 
присылать: присылать 
самый: самое 
важный: важное 
пропускать: пропустили 
это: это 
бесплатно: бесплатно 
каждый: каждый каждое каждую 
неделя: недели неделю 
личный: личном личный личными 
дайджест: дайджест 
мозг: мозг 
технология: технологии 
эмиграция: эмиграция 
спорт: спорт 
животное: животные 
налог: налоги 
изумительный: изумительные 
дискуссия: дискуссии 
ребенок: дети ребенке 
читатель: читатели читателей 
писать: пишут 
бесить: бесит 
выплата: выплаты 
льгота: льготы 
ama: ama 
авто: авто 
пенсия: пенсия 
город: город 
получать: получить получать 
среда: среду 
суббота: субботу 
главное: главное 
хороший: лучшие 
статья: статьи 
искусство: искусстве 
управление: управления 
финансы: финансами 
тысяча: тысяч тысяча тысячи 
подписчик: подписчиков 
пример: пример 
понедельник: понедельник 
инвестник: инвестник 
вкладывать: вложить 
доход: доход 
отдавать: отдать 
мошенник: мошенникам 
воскресение: воскресенье 
чемодан: чемодан 
россия: россии 
другой: других 
страна: странах 
отдыхать: отдыхать 
учиться: учиться 
жить: жить 
вторник: вторникам вторник 
стакан: стакан 
вода: воды 
финансовый: финансовой 
сторона: стороне 
родительство: родительства 
разоряться: разориться 
дважды: дважды 
месяц: месяц 
пятница: пятницу пятницам 
автодайджест: автодайджест 
ездить: ездить 
штраф: штрафов 
переплачивать: переплачивать 
обслуживание: обслуживание 
автомобиль: автомобиля 
четверг: четвергам четверг 
зарабатывать: зарабатывать 
свой: своем свой 
дело: деле 
угол: угол 
покупать: покупать 
продавать: продавать 
снимать: снимать 
жилье: жилье 
делать: делать 
ремонт: ремонт 
экономить: экономить 
жку: жку 
новый: новые 
повлиять: повлияют 
ваш: ваши 
норма: норма 
тот: тех 
хотеть: хочет 
лечиться: лечиться 
эффективно: эффективно 
недорого: недорого 
действенный: действенных 
способ: способах 
поддаваться: поддаваться 
стресс: стрессу 
ошибка: ошибках 
мышление: мышления 
пост: посты 
бюджет: бюджете 
покупка: покупках 
все: всем 
волновать: волнует 
появляться: появляются 
новость: новости 
курсы: курсы 
жизнь: жизнь 
богатеть: богатеть 
терять: терять 
вакансия: вакансии 
сообщать: сообщить 
проблема: проблеме 
проект: проекте 
контакт: контакты 
политика: политика 
конфиденциальность: конфиденциальности 
правило: правила 
пользование: пользования 
сайт: сайтом 
выходить: выйти 
ао: ао 
банк: банк 
лицензия: лицензия 
