кинопрокат: кинопрокате кинопрокат кинопрокату кинопроката 
россия: россия россии россией 
итог: итоги итогам 
сборы: сборы сборах 
прогноз: прогноз прогнозы 
киноиндустрия: киноиндустрия киноиндустрии 
год: год годов годы году лет года годом лета 
промой: промо 
заклинание: заклинание 
бесплатный: бесплатный бесплатную 
кредитка: кредитку 
fgo: fgo 
заказывать: заказать 
карта: картах карту 
учебник: учебник 
сравнятор: сравнятор 
сообщество: сообщество 
ипотека: ипотека 
кредитный: кредитная 
история: историю история истории 
тест: тесты 
дневник: дневники дневник 
трата: трат 
налоговый: налоговые налоговую налоговый 
вычет: вычет 
написать: написать 
инвестиция: инвестиции 
бизнес: бизнес бизнеса 
разбор: разборы 
закон: закона законов закон законы законе 
калькулятор: калькуляторы 
путешествие: путешествия 
медицина: медицина 
здоровье: здоровье 
недвижимость: недвижимость 
подкаста: подкасты 
видео: видео 
смотреть: смотрят смотрю смотреть смотрела 
сервис: сервис сервисы 
расчет: расчеты 
закладка: закладки 
письмо: письма 
оставаться: остался останется оставайтесь 
деньги: деньгами деньги денег 
поток: потоки потоке 
январь: январе январем января январь 
становиться: станет стал стало стали стала 
хороший: лучшим хороший лучшие хорошим хорошее лучший лучшем 
месяц: месяца месяцем месяц месяцев 
ждать: ждет 
индустрия: индустрией индустрия индустрию индустрии 
далеко: далеко дальше 
участник: участникам участников участники 
рынок: рынок рынке рынка 
довольный: довольны 
сбор: сборам сборами сборов 
первый: первых первого первые первый 
будущее: будущее будущего 
скоро: скорее 
пессимизм: пессимизмом 
саша: саша 
кириллов: кириллова 
ходить: ходить ходили ходил хожу ходите ходят ходила ходим ходит 
кино: кино 
профиль: профиль 
автор: автора авторов 
официально: официально 
прокатывать: прокатывать прокатывают прокатывали прокатывает 
крупный: крупные крупных крупнейшем 
мировой: мировой мировые 
новинка: новинок новинки 
кинотеатр: кинотеатр кинотеатрах кинотеатром кинотеатры кинотеатров кинотеатре кинотеатрам 
выдерживать: выдержали 
такой: такая такого такому такое такими таких такие такую 
ограничение: ограничений ограничения 
около: около 
закрываться: закрываться закрылось закроются 
больший: большая 
часть: часть 
адаптироваться: адаптировалась 
новый: новый новые новых новой новая 
реальность: реальности 
пусть: пусть 
законный: законными законно 
метод: методами 
например: например 
появляться: появится появилась появился появилось 
прокат: прокат прокатами прокате проката прокату прокатом 
это: этому это 
зарубежный: зарубежных зарубежные 
фильм: фильмы фильм фильма фильмам фильмов фильму фильмом 
показывать: показали показывать показывают показывали 
лицензия: лицензия лицензии лицензию лицензий 
прокатный: прокатного прокатной прокатных 
удостоверение: удостоверений удостоверения 
начинаться: начался 
побивать: побил побиты 
несколько: несколько нескольких 
рекорд: рекордов рекорды 
позволять: позволила позволяет позволил позволит 
закрывать: закрыть закрывать 
некоторые: некоторые некоторых 
долг: долги 
откладывать: отложить 
пока: пока 
равно: равно 
выглядеть: выглядит 
туманный: туманно 
студия: студии студий студия 
вряд: вряд 
вернуться: вернутся 
российский: российскому российским российские российская российский российских российское российском российского 
приносить: принесли приносит 
большой: больших большое большом большую большой большого 
доход: доходов 
разбираться: разбираемся разбираться 
материал: материале 
узнавать: узнаете 
какой: какие каким какого 
получаться: получится получился 
почему: почему 
рекордный: рекордным 
происходить: происходящему происходит 
теневой: теневой теневого теневому теневым 
предлагать: предлагает предлагают 
власть: власти 
делать: делать делали делают 
курс: курс 
общаться: общаться 
понимать: понимаете понимал понимаю понимать понять 
друг: другу друг друга 
бережно: бережно 
окружающий: окружающими 
часто: чаще часто 
получать: получат получать получили 
желать: желаемое 
изучать: изучить 
работать: работать работали работает 
голливудский: голливудские голливудское голливудского голливудских 
март: марта марте 
уходить: ушли 
многие: многие многим 
компания: компании компаний компания 
sony: sony 
warner: warner 
bros: bros 
disney: disney 
общий: общие общий 
составлять: составил составить составили 
млрд: млрд 
рубль: рублях рублей 
мало: мало меньше 
допандемийный: допандемийном 
данный: данным 
еаис: еаис 
собирать: собрали собирать собрана собрала собрал 
приключенческий: приключенческий 
богатырь: богатырь 
посланник: посланник 
тьма: тьмы 
выходить: выйти вышли вышло выходило выходят вышел выйдет выходит 
декабрь: декабре декабрь декабря 
второй: втором второй второго второе 
третий: третий третье 
место: место мест 
занимать: занял заняли занимать 
картина: картин картины картина 
значиться: значится 
путь: пути путями путь 
домой: домой 
экран: экраны экране экраном экран экрана 
февраль: феврале февраля 
отмена: отмены 
другой: другое других другим 
премьер: премьер 
течение: течение 
единый: единая 
автоматизированный: автоматизированная 
информационный: информационная 
система: система систему 
который: который которой которых которые которую которыми которому 
весь: вся всей 
информация: информация 
бюджет: бюджетах бюджет бюджете 
официальный: официальные официальном 
самый: самым самые самый самой самых 
кассовый: кассовым кассовый кассовые кассовых 
название: название 
дата: даты дата 
премьера: премьеру премьерой премьеры 
страна: страны стран страна стране 
р: р 
время: времена время времени 
сша: сша 
парма: пармы 
октябрь: октября 
франция: францию франция 
япония: япония 
источник: источники источник 
проблема: проблемы проблему проблеме 
нехватка: нехватки 
контент: контента контент 
решать: решать решить решали 
разный: разные разными 
сначала: сначала 
старый: старые старых 
затем: затем 
начинать: начали начнут начинаешь 
нелегальный: нелегального нелегальными нелегально нелегальные нелегальных нелегальный 
повторный: повторные повторный повторном 
кинопрокатчик: кинопрокатчика кинопрокатчик 
запускать: запустил запустили 
показ: показами показов показом показы показ 
популярность: популярность популярностью популярности 
пользоваться: пользовались пользуется 
оба: оба 
млн: млн 
сумма: сумма суммы 
вырастать: вырос выросла 
приключение: приключений приключение 
также: также 
успешно: успешно 
зарабатывать: заработал заработала заработали заработать зарабатывают 
скромный: скромного 
репертуар: репертуара 
помогать: помогает помогло помочь 
один: одну одного одном одной 
киносеть: киносетями киносетей киносетях 
анонимно: анонимно 
рассказывать: рассказал расскажите 
ниша: ниша 
устойчивый: устойчива 
стабильный: стабильным 
спрос: спрос спросом 
называть: называют назвать 
запредельный: запредельным 
любой: любой любом любые 
современный: современный 
ужас: ужасов 
категория: категории 
мы: нам 
покрывать: покрывать покрытый 
благородный: благородной 
патина: патиной 
слеза: слезами 
восторг: восторга 
киновед: киноведов 
шедевр: шедевром шедевр 
отмечать: отмечает отметил отметили 
придумывать: придумали 
способ: способов способами способ 
обходить: обойти 
сторонний: сторонние сторонних 
организатор: организаторов 
предсеансовый: предсеансового 
обслуживание: обслуживания 
популярный: популярное популярный 
последний: последнего последни последний последним последние 
копия: копии копий копия 
включать: включают включенных включить 
короткометражный: короткометражные короткометражных короткометражный 
юрский: юрского 
период: период периода 
вода: воды 
непростой: непростая 
ситуация: ситуацию ситуации ситуация 
приводить: привела 
то: тому 
житель: жители 
посещать: посещать 
россиянин: россияне россиян 
купить: купили купить 
раз: разу раза 
билет: билеты билетов 
ранее: ранее 
гендиректор: гендиректор гендиректора 
офис: офиса 
аналитический: аналитической 
comscore: comscore 
роман: роман романа 
исаев: исаев 
аудитория: аудитория 
утрачивать: утратила 
привычка: привычку 
главный: главным 
удар: ударом 
заметный: заметных 
рекламный: рекламных 
кампания: кампаний 
зритель: зрителя зритель зрителей зрителям зрители 
видеть: видит вижу видела 
конец: конца концу 
подсчитывать: подсчитать подсчитали 
ассоциация: ассоциации ассоциация 
владелец: владельцев 
лето: летом 
организация: организации 
пессимистичный: пессимистичный 
говорить: говорит говорила говорили 
возможный: возможном 
закрытие: закрытии закрытие 
половина: половины половину 
зал: залы зале залов 
опасение: опасения 
оправдываться: оправдались 
удаваться: удалось 
сокращать: сократить 
затрата: затраты 
зарплата: зарплатой зарплатам 
договариваться: договориться 
арендатор: арендаторами 
снижение: снижении 
плата: платы 
суммарный: суммарно 
прирост: прирост 
сравнение: сравнения сравнению сравнение 
результат: результат 
справедливый: справедлив 
валюта: валюте 
превосходить: превзойти 
доллар: долларов 
против: против 
число: числе число числа 
релиз: релизы релиза релизов 
сокращаться: сократится сократилось 
пять: пять 
январский: январский 
связанный: связаны связано 
пандемия: пандемией 
covid: covid 
производство: производство 
многий: многих 
останавливать: остановили 
перенести: перенесли 
высокий: высокие высоком высокими 
обязанный: обязаны 
девять: девять 
день: дней 
причина: причина причины причине причин 
посмотреть: посмотрела посмотреть посмотрел посмотрели 
великобритания: великобритания 
царевич: царевич 
серый: серый 
волк: волк 
добрый: добрых 
дело: дела 
ноябрь: ноябре ноября 
вероятно: вероятно 
частность: частности 
мнение: мнению мнение 
партнершип: партнершип 
вадим: вадим вадима 
верещагин: верещагин верещагина 
успех: успеха 
персонаж: персонажа персонажей 
качество: качества качестве качеством 
лента: лент ленты 
традиционно: традиционно 
сезон: сезоне 
новогодний: новогодних 
праздник: праздников 
семья: семьями семьей 
важный: важную 
роль: роли роль 
сыграть: сыграла сыграли 
просмотр: просмотры просмотр просмотра 
прокатчик: прокатчика 
сходить: сходили 
управлять: управляющий 
иркутский: иркутским 
new: new 
cinema: cinema 
егор: егор 
иваненко: иваненко 
заявлять: заявили заявил 
увеличивать: увеличила 
остальной: остальных 
мочь: могу могли могло могут 
хватить: хватить хватит 
идти: идут шли идущие 
директор: директор 
омск: омск 
дмитрий: дмитрия дмитрий 
савельев: савельев 
считать: считает считать считают 
широкий: широкий широком широкая 
демография: демография 
человек: человека люди людей человеку человек 
приходить: пришли 
впервые: впервые 
десятилетие: десятилетия 
пенсионный: пенсионного 
возраст: возрастом возрасте возраста 
важно: важно 
лидировать: лидируют 
корень: корень 
зло: зла 
переносить: переносят переносили 
каникулы: каникулах каникул каникулы 
поздний: поздние 
спасение: спасения 
мужчина: мужчина 
парень: парни 
навсегда: навсегда 
точный: точного точные 
сложно: сложно 
естественно: естественно 
вести: ведет 
учет: учет 
сам: сами 
маскировать: маскируют 
продажа: продажи 
побочный: побочный 
входить: входят вошли 
топ: топ 
свидание: свидания 
вместе: вместе 
они: ними ими 
джеймс: джеймса 
кэмерон: кэмерона 
кадр: кадр 
century: century 
studios: studios 
проходить: пройдут проходят прошли 
спустя: спустя 
состояться: состоялась 
профильный: профильного 
издание: издания 
заключать: заключили 
соглашение: соглашение 
обязываться: обязались 
расписание: расписании 
вид: видом виде 
изменять: изменит 
подсчет: подсчета 
мир: мира 
потратить: потратила потратил 
июль: июля 
плакать: плачут 
зато: зато 
оно: оно 
ссылка: ссылкой ссылку 
писать: пишут пишет 
минкультуры: минкультуры 
знать: знает знаю 
лазейка: лазейке 
бороться: бороться 
министерство: министерство министерства министерстве 
оштрафовать: оштрафовали 
ряд: ряд 
стрэндж: стрэндж 
мультивселенная: мультивселенной 
безумие: безумия 
господство: господство 
слово: слово словам слова 
собеседник: собеседника собеседники 
газета: газеты 
соглашаться: согласятся 
штраф: штрафы 
отказываться: откажутся 
кроме: кроме 
привлекать: привлечь 
ответственность: ответственности 
просто: просто 
отвечать: отвечая отвечают ответить 
быстро: быстро 
самоликвидироваться: самоликвидируются 
относиться: относятся 
негативно: негативно 
апрель: апреля апреле 
опубликовывать: опубликовала 
заявление: заявление 
осуждать: осуждать осудила 
практика: практику 
демонстрация: демонстрация 
ворованный: ворованных 
выводить: выводит 
правовой: правового 
поле: поля 
возвращать: возвращает 
темный: темные 
позиция: позицией 
согласный: согласен согласна 
московский: московской 
школа: школы 
мария: мария 
ситковская: ситковская 
краткосрочный: краткосрочные 
задача: задачи 
кинопоказ: кинопоказа 
приучать: приучает 
платить: платил платить 
вопрос: вопросу вопрос 
завтра: завтра 
проект: проекте проекта проектов проект проекты 
понести: понесут 
рассуждать: рассуждает 
снимать: снять снял снимали снята 
отменять: отменить отмененного 
глава: главы глава 
подчеркивать: подчеркивает 
свое: свое 
отрицательный: отрицательное 
отношение: отношение 
именно: именно 
этот: этих эта 
мера: мера мере меры 
большинство: большинство большинству большинства 
доживать: дожить доживать 
факт: факт 
пиратство: пиратством пиратства 
создавать: создает 
разрушать: разрушает 
обычно: обычно 
оставлять: оставляет 
остальное: остальное остальном 
делить: делят 
создатель: создатели 
случай: случае 
забирать: забирают 
сколько: сколько 
реально: реально 
июнь: июня 
действовать: действует 
параллельный: параллельном параллельного 
импорт: импорте импорта 
товар: товаров товарам товары 
минпромторг: минпромторгом минпромторг минпромторге 
специальный: специальный 
список: список списки 
перечень: перечень 
разработка: разработке 
документ: документа 
обсуждаться: обсуждалась 
возможность: возможность 
туда: туда 
обновлять: обновил 
продукция: продукция 
marvel: marvel 
pixar: pixar 
dc: dc 
изменение: изменение 
касаться: коснулось 
мерч: мерча 
применять: применять 
номенклатура: номенклатуре 
еаэс: еаэс 
ведомство: ведомство ведомства ведомстве 
противоречить: противоречащие 
вариант: варианты 
разрешение: разрешения 
повлиять: повлиять 
экономика: экономику экономика 
совет: совет 
федерация: федерации 
разрабатывать: разработало 
законопроект: законопроект 
устанавливать: установят 
мораторий: мораторий 
административный: административное 
наказание: наказание 
нарушение: нарушение нарушением 
сторона: стороны 
иностранный: иностранные иностранного иностранным иностранный иностранных 
государство: государство государства 
заместитель: заместителя 
комитет: комитета 
сф: сф 
экономический: экономической 
политика: политике политика 
алексей: алексей алексея 
синицын: синицына 
недостаточно: недостаточно 
держать: держать 
плав: плаву 
потребоваться: потребуется 
согласие: согласия 
правообладатель: правообладателей 
наращивать: нарастит 
намерен: намерена намерено 
пресекать: пресекать 
пиратский: пиратского пиратских 
собираться: собираются собирается 
подготовить: подготовить 
запрещать: запрещающий 
тема: тему 
обсуждать: обсуждают 
кинематографический: кинематографических 
департамент: департаментах 
киноаналитик: киноаналитик 
сергей: сергей сергея 
бондарев: бондарев 
возможно: возможно 
нелицензионный: нелицензионный 
мешать: мешать 
заработок: заработку 
маркетинг: маркетинг 
вложиться: вложилось 
идея: идеи 
узаконивание: узаконивания 
принудительный: принудительное 
лицензирование: лицензирование 
приветствовать: приветствуют 
необходимость: необходимости 
повлечь: повлечет 
себя: собой 
неприятный: неприятные 
последствие: последствия 
ответный: ответной 
западный: западных западные 
прекращать: прекратить 
защита: защиту 
платформа: платформах 
обращаться: обратиться 
суд: суд 
партнер: партнер 
разрывать: разорвал 
лицензионный: лицензионный 
договор: договор договору 
основание: основаниям 
выдавать: выдадут 
принудительно: принудительно 
распространяться: распространяется 
изобретение: изобретения 
полезный: полезные 
модель: модели моделей 
промышленный: промышленные 
образец: образцы 
представитель: представители 
поговорить: поговорил 
навредить: навредит 
опасаться: опасаются 
испугать: испугает 
тот: те та 
сотрудничать: сотрудничают 
гораздо: гораздо 
хотеть: хотела хотят хотели хочет 
увидеть: увидят увидеть 
поддержка: поддержка поддержке поддержку 
запланировать: запланировано запланированных 
выживание: выживания 
развитие: развития развитию 
нужный: нужна 
прямой: прямая 
субсидия: субсидии субсидия 
некий: некий 
подход: подход 
уход: уход ухода уходом 
голливуд: голливуд голливуда 
оказываться: оказалось оказались 
перестраиваться: перестроились перестроиться 
министр: министр 
культура: культуры 
ольга: ольга 
любимова: любимова 
поддерживать: поддерживать поддержанных поддержать 
речь: речь 
финансовый: финансовой финансовая 
стимулирование: стимулировании 
отечественный: отечественным отечественного отечественные 
стараться: стараемся 
нужно: нужно 
выделять: выделить выделили 
диалог: диалога 
выяснять: выяснить выяснили 
должно: должно 
успешный: успешны успешный успешным 
вселять: вселяют 
оптимизм: оптимизма 
несмотря: несмотря 
дьяченко: дьяченко 
планировать: планируют планируем планировали 
собранный: собранных 
исправление: исправления 
негативный: негативные 
авк: авк 
воронкова: воронкова 
выход: выхода 
кризис: кризиса 
хотя: хотя 
ноль: ноль 
минус: минус 
десять: десять 
продюсер: продюсеры продюсеров 
обещать: обещают 
кратный: кратное 
увеличение: увеличение 
качественный: качественного 
единственный: единственный единственная 
достигать: достиг 
воронок: воронков 
понадобиться: понадобились понадобится 
восстановление: восстановления 
показатель: показателей показателям 
кинематограф: кинематографу кинематограф 
выпускать: выпускать выпустит выпустила выпустили выпускаемых 
критерий: критерию 
исаева: исаева 
планироваться: планируется 
миллиардный: миллиардным 
потенциал: потенциалом 
заканчиваться: закончатся 
быть: будут 
тревога: тревоге 
парк: парк 
васянин: васянин 
графика: графика 
середина: середину 
сей: сих 
пора: пор 
выстреливать: выстрелил 
эйфория: эйфория 
неопределенность: неопределенность 
указывать: указывает 
рюмочный: рюмочные 
ресторан: рестораны 
музей: музеи 
неочевидный: неочевидных 
кинозал: кинозалов 
москва: москве москвы 
оценка: оценкам 
эксперт: экспертов эксперты 
просаживать: просадить 
продолжать: продолжат продолжает 
нерентабельность: нерентабельности 
прогнозировать: прогнозирует прогнозировать 
годовой: годовой 
высоко: выше 
примерно: примерно 
вернуть: вернет вернуть 
свой: свои свой 
обеспечивать: обеспечит 
количество: количество 
позитивный: позитивные 
настраивать: настроены 
оптимистичный: оптимистично 
относительно: относительно 
меньшинство: меньшинство 
гум: гума 
этери: этери 
кахидзе: кахидзе 
сказать: сказать 
падать: падал 
сотня: сотни 
обращать: обращает 
внимание: внимание 
пример: примеры 
национальный: национальный 
играть: играет играют 
ключевой: ключевую 
италия: италию 
китай: китай 
смочь: смогут смогли сможет 
председатель: председателя 
телевидение: телевидения 
сельянова: сельянова 
замещение: замещение 
рано: раньше 
объем: объем 
запущенный: запущенных 
сериал: сериалами сериалов 
канал: канал 
кинопроизводство: кинопроизводства 
однако: однако 
фонд: фонда фондом 
коммерчески: коммерчески 
рбк: рбк 
комедия: комедия комедии 
александра: александра 
фомин: фомина 
отбивать: отбить 
кот: кота 
море: море 
гек: гек 
отличие: отличие 
особый: особой 
прибыль: прибыли 
способствовать: способствовать 
помощь: помощь 
литературный: литературных 
издательство: издательств 
известно: известно 
инвестировать: инвестировать 
экранизация: экранизации экранизация 
она: ею её 
книга: книг 
дальнейший: дальнейшем 
группа: группа 
стоимость: стоимости 
финансирование: финансирование 
сформировывать: сформирован 
питчинга: питчинги 
получение: получения 
основной: основное 
гай: гая 
ричи: ричи 
режиссер: режиссера 
весна: весной 
джейк: джейком 
джилленхолом: джилленхолом 
энтони: энтони 
старр: старром 
боевик: боевик 
стэйтем: стэйтемом 
стоять: стоит 
май: мая 
комедийный: комедийный 
страх: страхи 
бо: бо 
ари: ари 
астер: астера 
хоррор: хоррор 
мужской: мужской 
французский: французское 
работа: работу 
возобновлять: возобновляет 
pathé: pathé 
план: планах 
два: две 
обеликс: обеликс 
поднебесный: поднебесная 
мушкетер: мушкетеров 
ева: евой 
грин: грин 
венсан: венсаном 
кассель: касселем 
должный: должен должны 
неопределенный: неопределенный 
срок: срок 
начало: начало 
постить: постим 
кружочек: кружочки 
красивый: красивые красивый 
карточка: карточки 
новость: новости 
технология: технологиях 
наш: нашего нашем 
подписываться: подписывайтесь 
классно: классно 
тэг: тэги 
актуальный: актуальное 
обложка: обложка 
mixmedia: mixmedia 
istock: istock 
редко: реже редко 
комментарий: комментарии 
модерация: модерацию 
правило: правилам правила 
журнал: журнала 
темич: темич 
супергерой: супергерой 
осознавать: осознал 
бэтмена: бэтмена 
неделя: неделю 
стабильно: стабильно 
ваньш: ваньша 
герой: героя герой героев 
кажется: кажется 
аллея: аллею 
кошмар: кошмаров 
pedro: pedro 
аналогично: аналогично 
ivan: ivan 
petrov: petrov 
чебурашка: чебурашку чебурашке чебурашка чебурашки 
бить: бьет 
кремировать: кремирован 
мой: моему 
сценарий: сценария сценарий сценарию 
посильный: посильнее 
малахов: малахов 
ребенок: детям дети детей ребенку 
зайти: зашло 
имхо: имхо 
нормальный: нормального нормальный 
детский: детский 
анатолий: анатолий 
приходько: приходько 
думать: думаю 
взрослый: взрослые взрослом 
правильный: правильном 
положительный: положительном 
смысл: смысла смысле смысл 
беда: беда 
прожевывать: прожуют 
плюшка: плюшка 
столько: столько 
дима: дима 
столбик: столбик 
эксел: экселе 
yuriy: yuriy 
belkin: belkin 
пара: пару 
татьяна: татьяна 
отредактировать: отредактировано 
принцип: принципу принципе 
рад: рада 
существовать: существует 
театр: театры театр 
постановка: постановки 
очень: очень 
радоваться: радуюсь 
старое: старое 
уносить: унесенных 
ветер: ветров ветер 
великолепный: великолепные 
впечатление: впечатления впечатлений 
дома: дома 
alexandra: alexandra 
забывать: забыли 
отбирать: отобрали 
паспорт: паспорт 
bmo: bmo 
посещение: посещении 
детство: детстве 
непонятно: непонятно 
звук: звук звука 
уютный: уютный 
диван: диване диван 
напиток: напитки 
закуска: закуски 
тащиться: тащится 
сидеть: сидеть 
куча: кучей 
aleksandr: aleksandr 
alekseev: alekseev 
сильно: сильнее сильно 
снусмумрик: снусмумрик 
концерт: концерт концерты 
музыка: музыку 
спокойный: спокойной 
атмосфера: атмосфера атмосфере 
послушать: послушать 
запись: записи 
несравнимый: несравнимые 
вещь: вещи 
живой: живого 
исполнение: исполнения 
жизнь: жизнь 
отличаться: отличается 
домашний: домашнего 
размер: размером 
видеозапись: видеозапись 
imax: imax 
аймакс: аймакс 
определенный: определенного 
формат: формат 
добавлять: добавляет 
среднестатистический: среднестатистическом среднестатистический 
мероприятие: мероприятия 
круто: круто 
максимум: максимум 
телек: телек 
тип: типа 
каждый: каждом 
дом: доме 
плазма: плазма 
здоровенный: здоровенная 
поход: походе 
беситься: беситься 
задний: задних 
сидение: сиденьях 
громко: громко 
жевать: жует 
хохотать: хохочет 
уютно: уютнее 
спокойно: спокойнее 
пауза: паузу 
поставлять: поставлять поставить 
момент: момент 
ложиться: лечь 
вовсе: вовсе 
podzhok: podzhok 
pukanoff: pukanoff 
ради: ради 
оранжевый: оранжевый 
лис: лис 
кичиться: кичиться 
интерес: интересе 
отсутствие: отсутствии 
мультфильм: мультфильмов 
переставать: перестали 
пираток: пиратки 
крутить: крутят 
оборудование: оборудовании 
простаивать: простаивают 
клеопатра: клеопатра 
кед: кедах 
михаил: михаил 
сравнивать: сравнила сравниваете 
паддингтон: паддингтоном 
проигрывать: проигрывает 
слабый: слабого 
раскрывать: раскрытых 
характер: характеров 
уровень: уровня 
комплимент: комплимент комплименты 
отсыпать: отсыпали 
набор: набор 
шаблон: шаблонов 
вместо: вместо 
хобби: хобби 
надежда: надежды 
средний: средний 
одноразовый: одноразовый 
точно: точно 
значение: значение 
шазелла: шазелла 
дель: дель 
торо: торо 
спилберг: спилберга 
блокьастер: блокьастером 
являться: является 
увы: увы 
извинять: извините 
поверять: поверю 
обладать: обладать 
потрясающий: потрясающей 
всеядность: всеядностью 
безразличие: безразличием 
искусство: искусству 
колоссальный: колоссальной 
толерантность: толерантностью 
добровольно: добровольно 
треть: трети 
прошлое: прошлого 
реальный: реальное 
существование: существование 
вериться: верится 
разница: разница 
выбор: выбора выбор 
блокбастер: блокбастеры 
обязательно: обязательно 
попкорн: попкорн 
европейский: европейский европейские 
азиатский: азиатский 
южноамериканский: южноамериканский 
документалка: документалки 
фестивальный: фестивальные 
ограниченный: ограниченном ограниченный 
дюжина: дюжине 
питер: питере питера 
игровой: игровое 
предоставлять: предоставляют 
p: p 
жить: живу живет 
весьма: весьма 
разнообразный: разнообразны 
предубеждение: предубеждение 
подряд: подряд 
интересно: интересно 
вполне: вполне 
понятно: понятно 
унылый: унылые 
посредственность: посредственность посредственности 
вверх: вверх 
понравиться: понравившихся понравилось 
бес: бес 
уверенный: уверен 
широко: широко 
прокатываться: прокатывался 
крайний: крайней 
причем: причем 
принципиальный: принципиальный 
противник: противник 
предыдущий: предыдущие 
вечер: вечером 
воровать: ворованное ворованные 
реклама: рекламу 
три: трех 
топор: топоров 
интернет: интернете 
рыночный: рыночная 
все: всем всё 
одинаковый: одинаковые 
условие: условия 
ага: ага 
помнить: помню 
поздно: попозже 
агрегатор: агрегаторы 
приложение: приложения 
тинькофф: тинькофф 
яндекс: яндекс 
афиша: афиши 
vольга: vольга 
интересовать: интересовало 
платный: платной 
подписка: подписке 
иви: иви 
yummy: yummy 
андрей: андрей 
принципиально: принципиально 
соображение: соображениям 
интересный: интересные 
экшнов: экшнов 
зрелищность: зрелищности 
александров: александров 
натяжка: натяжкой 
вообще: вообще 
верить: верю 
никак: никак 
голова: голове 
укладываться: укладывается 
убивать: убей 
видимо: видимо 
семейный: семейное 
целый: целыми 
максим: максим 
иванов: иванов 
шеф: шеф 
ваш: ваши вашу 
статья: статью 
прикладывать: приложить 
роза: роза 
каинов: каинова 
возвращение: возвращение 
далее: далее 
логично: логично 
нга: нг 
свободный: свободного 
киношник: киношники 
ориентировать: ориентированные 
плохо: плохо хуже 
сделать: сделав сделали 
объявлять: объявили 
едва: едва 
сейлор: сейлор 
марс: марс 
зима: зимы 
случайно: случайно 
забредать: забрели 
охотник: охотники 
сокровище: сокровищами 
поверить: поверить 
заставлять: заставить 
надеяться: надеюсь 
маленький: маленьким 
правда: правда 
здорово: здорово 
необычный: необычного 
оживлять: оживить 
короче: короче 
довольствоваться: довольствуюсь 
зря: зря 
визуально: визуально 
ботанический: ботанический 
сад: сад 
мультик: мультике 
отрисовывать: отрисован 
нормально: нормально 
неплохо: неплохо 
oly: oly 
поделиться: поделиться 
кинопоиск: кинопоиск 
знакомый: знакома 
авторский: авторским 
тарковский: тарковского 
балабанова: балабанова 
звягинцев: звягинцева 
alexandr: alexandr 
обсасывать: обсасывать 
скончание: скончания 
век: веков 
когорта: когорту 
побеждать: победили 
гагарин: гагарин 
переливание: переливания 
пустой: пустого 
порожний: порожнее 
исчерпывающий: исчерпывающе 
умещать: уместить 
строка: строки 
лишать: лишили 
поэтому: поэтому 
пойти: пошли 
безрыбье: безрыбье 
рак: рак 
рыба: рыба 
художественный: художественные 
никакой: никакой 
узнаваемый: узнаваемый 
образ: образ 
требоваться: требовалось 
минимально: минимально 
вменяемый: вменяемым 
избегать: избежать 
подобие: подобия 
сцена: сцен 
сладкий: сладкого 
хлеб: хлеба 
покушать: покушать 
крокодил: крокодилу 
ген: гене 
мошенник: мошенникам 
справка: справки 
репетитор: репетитор 
полагаться: полагался 
налог: налог налоги 
инвалидность: инвалидностью 
копить: копить 
покупать: покупать 
балл: баллы 
уведомлять: уведомлять 
счет: счет счетах 
белоруссия: белоруссии 
работник: работник 
работодатель: работодателю 
ипать: ип 
молодой: молодой 
оформлять: оформить 
машина: машину 
риск: риски 
сосед: соседи 
заливать: залили 
дверной: дверную 
ручка: ручку 
замок: замок 
клей: клеем 
протест: протест 
ремонт: ремонта 
завещание: завещание 
муж: мужа 
имущество: имущество 
здание: здание 
баланс: баланс 
багаж: багажом 
возникать: возникали 
поездка: поездках 
косметичка: косметичка 
чувствительный: чувствительной 
комбинированный: комбинированной 
кожа: кожей 
акна: акне 
покупатель: покупателя 
продавец: продавец 
вносить: внесет 
доля: доли 
обучение: обучение 
отрабатывать: отработала 
целевой: целевому 
процент: проценты 
посылка: посылка 
застревать: застряла 
таможня: таможне 
стаут: стауты 
гоза: гозе 
ламбик: ламбики 
пить: пить 
крафтовый: крафтовое 
пиво: пиво 
бали: бали 
въезд: въезда 
сербия: сербию 
поколение: поколение 
девяностый: девяностых 
лишний: лишнее 
труд: труда 
беспроводный: беспроводные 
колонка: колонки 
удачный: удачных 
розничный: розничной 
сеть: сети 
поволжье: поволжье 
экономист: экономист 
дежурный: дежурный 
электромонтер: электромонтер 
новосибирск: новосибирске 
тратить: тратила 
классный: классные 
apple: apple 
watch: watch 
вакансия: вакансии 
сообщать: сообщить 
контакт: контакты 
конфиденциальность: конфиденциальности 
пользование: пользования 
сайт: сайтом 
ао: ао 
банк: банк 
