отчет: отчет 
год: год году лет года годом 
финансовый: финансовые 
операционный: операционные 
результат: результатами результаты результатам 
компания: компании компания 
промой: промо 
увеличивать: увеличила увеличьте 
доход: доходы доход 
сообщество: сообществом сообщество 
инвестор: инвесторов 
это: этому это 
работать: работает 
учебник: учебник 
сравнятор: сравнятор 
ипотека: ипотека 
кредитный: кредитная 
история: история 
тест: тесты 
дневник: дневники дневник 
трата: трат 
налоговый: налоговые налоговую налоговый 
вычет: вычет 
написать: написать 
инвестиция: инвестиции инвестициях инвестициями 
бизнес: бизнесов бизнес бизнеса 
разбор: разборы 
закон: законов 
калькулятор: калькуляторы 
путешествие: путешествия 
медицина: медицина 
здоровье: здоровье 
недвижимость: недвижимость 
подкаста: подкасты 
видео: видео 
смотреть: смотреть 
сервис: сервиса сервисы сервисами сервис сервисов 
расчет: расчеты 
закладка: закладки 
письмо: письма 
оставаться: остался остается оставайтесь оставаться 
деньги: деньгами деньги денег 
поток: потоки 
инвестразбор: инвестразборы 
фокус: фокус 
эффективность: эффективности эффективность 
yandex: yandex 
yndx: yndx 
р: р 
купить: купить 
партнерство: партнерстве 
тинькофф: тинькофф 
котировка: котировки 
обновляться: обновляются 
минута: минут 
международный: международную международная 
технологический: технологическая 
основывать: основанная 
россия: россии 
образовывать: образована 
отдельный: отдельная 
зарегистрироваться: зарегистрировалась 
нидерланды: нидерландах 
объединять: объединила объединяет объединенными 
актив: активы 
база: базе 
n: n 
v: v 
владеть: владеет 
поиск: поиска 
маркетплейс: маркетплейс маркетплейса маркетплейсе маркетплейсами 
доставка: доставки 
еда: еды 
музыка: музыки 
каршеринг: каршеринг каршеринга 
другой: другие других другими 
проект: проекте проектами 
экосистема: экосистему 
февраль: феврале февраля 
опубликовывать: опубликовала 
квартал: кварталом квартал квартале квартала 
полный: полный 
главное: главное 
роман: роман 
романович: романович 
зарабатывать: зарабатывает 
профиль: профиль 
автор: автора автор 
редакция: редакция 
советовать: советует 
инвестировать: инвестировать 
быстрый: быстрые 
нескучный: нескучные 
урок: уроки 
вкладывать: вкладывать 
ум: умом 
изучать: изучить 
итог: итогам итоге 
общий: общее общая общей общий 
выручка: выручки выручка выручке 
вырастать: вырос выросли выросла выросло 
составлять: составило составил составить составила составили 
млрд: млрд 
рубль: рублей 
сравнение: сравнению сравнении 
скорректировать: скорректированной скорректированного скорректированная 
чистый: чистой чистая 
прибыль: прибыли прибыль 
млн: млн 
показатель: показатели показателей показателя показатель 
маржинальность: маржинальности маржинальность 
ebitda: ebitda 
увеличиваться: увеличилась увеличилось увеличился 
процентный: процентного процентных 
пункт: пункта 
означать: означает 
рост: роста ростом рост 
рентабельность: рентабельность рентабельности 
источник: источник 
продолжать: продолжил продолжает 
поддерживать: поддерживать 
сотрудник: сотрудников 
денежный: денежными 
выплата: выплатами 
компенсирующий: компенсирующими 
потеря: потерю 
невозможный: невозможных 
реализация: реализации 
опцион: опционов 
ограничение: ограничению ограничения 
торги: торгов 
акция: акциями акции акций 
биржа: бирже 
nasdaq: nasdaq 
цель: цели 
потратить: потратили 
опционный: опционной 
программа: программе 
участвовать: участвует 
тысяча: тысяч тысячи 
человек: человеку человек 
выделять: выделяет 
отчетный: отчетных отчетной 
сегмент: сегменты сегмент сегменте сегмента сегментов 
портал: портала портал 
включать: включает 
голосовой: голосового 
помощник: помощника 
алиса: алису алисой 
ряд: ряд 
беларусь: беларуси 
казахстан: казахстане 
доля: доля доли долю 
группа: группы 
аналогичный: аналогичным 
поисковый: поисковой поисковая поисковых 
прошлый: прошлым 
достигать: достигло достигнут достигла 
мобильный: мобильного мобильных 
устройство: устройств 
приходиться: пришлось 
запрос: запросов 
увеличение: увеличение увеличении увеличению 
связанный: связано 
хороший: хорошими лучшие 
рекламный: рекламной рекламных 
сеть: сети 
система: систем системе 
также: также 
повлиять: повлияли 
постоянный: постоянные 
развитие: развитие 
технология: технологий 
продукт: продуктов продуктах 
прежде: прежде 
электронный: электронной 
коммерция: коммерция коммерции 
малый: малого 
средний: среднего 
платформа: платформе платформы 
ios: ios 
непосредственно: непосредственно 
рыночный: рыночной 
фон: фоне 
изменение: изменению изменения 
конкурентный: конкурентной 
среда: среды 
сфера: сфера 
основной: основным 
драйвер: драйвером 
аренда: аренды 
самокат: самокатов 
количество: количество 
поездка: поездках поездок 
активный: активная активных активными активного 
водитель: водителя 
рынок: рынок рынке рынках рынка 
работа: работы 
счет: счет счетах 
действие: действий 
направлять: направленных 
улучшение: улучшение 
субсидия: субсидий 
зрелый: зрелых 
целое: целом 
партнер: партнеров 
месячный: месячная 
аудитория: аудитория 
go: go 
приложение: приложения 
который: который которые которых которая которое 
такси: такси 
обширный: обширный 
delivery: delivery 
club: club 
товарооборот: товарооборот 
раз: раза 
ассортимент: ассортимент 
товар: товаров товары 
конец: конца концу конец 
январь: январе января 
артикул: артикулов 
покупатель: покупателей покупателя 
продавец: продавцы продавцов продавец 
считаться: считаются 
тот: те той 
совершать: совершили совершали 
менее: менее 
один: одной 
продажа: продажи 
течение: течение 
месяц: месяца 
дата: даты 
продавать: продали продающих 
свой: свои 
несмотря: несмотря 
убыточный: убыточным 
убыток: убытка убыток 
против: против 
ранее: ранее 
развлекательный: развлекательные 
продюсерский: продюсерский 
центр: центр 
подписчик: подписчиков 
объявление: объявлений 
входить: входят входящая 
такой: такая 
динамика: динамика 
обусловливать: обусловлена 
удаваться: удалось 
добиваться: добиться 
благодаря: благодаря 
расти: растущему расти 
спрос: спросу 
внутренний: внутренних внутреннем 
начинать: начиная начал 
устойчивый: устойчивый 
компенсировать: компенсировало 
снижение: снижение 
услуга: услуг 
автомобильный: автомобильных 
вызывать: вызванное 
резкий: резким 
спад: спадом 
предложение: предложения 
новый: новых 
автомобиль: автомобилям автомобилей 
инициатива: инициативы 
беспилотный: беспилотным 
cloud: cloud 
экспериментальный: экспериментальные 
нераспределенный: нераспределенные 
направление: направления 
умный: умных 
период: периодом 
прошлое: прошлого 
уход: уход ухода уходу 
иностранный: иностранных иностранным 
облачный: облачного 
хранение: хранения 
данный: данных 
структура: структура 
прирост: прирост 
презентация: презентация 
стр: стр 
новость: новости новостей 
американский: американская американские 
фонд: фонды 
сделка: сделкам сделки 
материнский: материнской 
fmr: fmr 
инвестиционный: инвестиционный инвестиционные 
холдинг: холдинг 
fidelity: fidelity 
investments: investments 
первый: первый 
публичный: публичный 
случай: случай случаи 
момент: момента моменты 
остановка: остановки 
фирма: фирмы 
invesco: invesco 
capital: capital 
research: research 
global: global 
investors: investors 
сокращать: сократили 
капитал: капитале 
соответственно: соответственно 
мнение: мнению мнение 
участник: участников 
подобный: подобные 
нужный: нужны 
справедливый: справедливой 
оценка: оценки 
раздел: раздел разделом 
российский: российскую 
часть: части 
интернет: интернет 
попадать: попал 
программный: программный 
код: кода код 
размер: размер 
архив: архива 
гигабайт: гигабайт 
отчетность: отчетность отчетности 
уделять: уделил 
внимание: внимание 
проблема: проблемы проблеме 
сообщать: сообщить сообщил 
следующий: следующее 
фрагмент: фрагменты 
являться: являются 
устаревать: устаревшими 
соответствовать: соответствуют 
версия: версии 
использоваться: используется 
продакшень: продакшене 
некоторые: некоторые 
предназначать: предназначены 
решение: решения 
задача: задач 
применяться: применялись 
пользователь: пользователей 
чрезвычайно: чрезвычайно 
серьезно: серьезно 
относиться: относится 
инцидент: инциденту 
тщательный: тщательное 
расследование: расследование расследования 
выяснять: выяснить 
причина: причину 
масштаб: масштаб 
последствие: последствия 
утечка: утечки 
принимать: примет 
возможный: возможные 
мера: меры 
укрепление: укреплению 
политик: политик 
повышение: повышению 
управление: управления 
контроль: контроля 
повторяться: повторялись 
отреагировать: отреагировал 
позитивно: позитивно 
падение: падение 
индекс: индекса 
мосбиржа: мосбиржи 
большинство: большинстве большинства 
фишка: фишек 
мск: мск 
сам: сама 
давать: дала 
прогноз: прогнозов 
ссылаться: сославшись 
сложный: сложные 
макроэкономический: макроэкономические 
геополитический: геополитические 
фактор: факторы 
выглядеть: выглядит 
показывать: показали показать 
улучшаться: улучшились 
целевой: целевому целевых 
удачный: удачных удачным 
например: например 
обмен: обмену 
сентябрь: сентябре 
главный: главным 
вопрос: вопросом 
беспокоить: беспокоит 
будущий: будущий 
написание: написания 
наш: нашего нашем 
обзор: обзора 
тема: теме 
появляться: появилось 
поэтому: поэтому 
ясно: ясно 
быть: будут 
делить: делить 
позитивный: позитивные 
акционер: акционеров 
перспектива: перспективе 
мочь: могут 
опережающий: опережающий 
стоимость: стоимость стоимости 
упасть: упала 
прибыльный: прибыльным 
сложность: сложности 
касаться: касаются 
подписываться: подписывайтесь 
курс: курсе 
происходить: происходящего 
тэг: тэги 
яндекс: яндекс 
комментарий: комментарии 
проходить: проходят 
модерация: модерацию 
правило: правилам правила 
журнал: журнала 
zod: zod 
герой: герой 
покус: покус 
отвечать: ответить 
статья: статьи 
думать: думаю 
именно: именно 
дмитрий: дмитрий 
очень: очень 
познавательный: познавательно 
ваш: вашим 
банк: банк банком 
сбербанк: сбербанком 
рф: рф 
мошенник: мошенникам 
понадобиться: понадобились 
справка: справки 
репетитор: репетитор 
полагаться: полагался 
каникулы: каникулы 
платить: платил 
налог: налог налоги 
инвалидность: инвалидностью 
копить: копить 
покупать: покупать 
балл: баллы 
уведомлять: уведомлять 
белоруссия: белоруссии 
работник: работник 
поставлять: поставлять поставить 
работодатель: работодателю 
ипать: ип 
молодой: молодой 
хотеть: хочет 
оформлять: оформить 
машина: машину 
какой: какие 
риск: риски 
сотрудничать: сотрудничают 
сосед: соседи 
заливать: залили 
дверной: дверную 
ручка: ручку 
замок: замок 
клей: клеем 
протест: протест 
ремонт: ремонта 
завещание: завещание 
ребенок: дети детей 
муж: мужа 
получать: получать получили 
имущество: имущество 
здание: здание 
баланс: баланс 
рассказывать: расскажите 
багаж: багажом 
возникать: возникали 
косметичка: косметичка 
чувствительный: чувствительной 
комбинированный: комбинированной 
кожа: кожей 
акна: акне 
вносить: внесет 
сколько: сколько 
вернуть: вернуть 
обучение: обучение 
отрабатывать: отработала 
срок: срок 
договор: договор договору 
процент: проценты 
популярный: популярное 
неделя: неделю 
посылка: посылка 
застревать: застряла 
таможня: таможне 
делать: делать 
стаут: стауты 
гоза: гозе 
ламбик: ламбики 
место: мест 
пить: пить 
крафтовый: крафтовое 
пиво: пиво 
москва: москве 
жить: живет 
бали: бали 
зарплата: зарплатой 
въезд: въезда 
сербия: сербию 
россиянин: россиян 
поколение: поколение 
девяностый: девяностых 
лишний: лишнее 
труд: труда 
беспроводный: беспроводные 
колонка: колонки 
модель: моделей 
директор: директор 
розничный: розничной 
поволжье: поволжье 
экономист: экономист 
дежурный: дежурный 
электромонтер: электромонтер 
новосибирск: новосибирске 
несколько: несколько 
тратить: тратила 
классный: классные 
впечатление: впечатления 
apple: apple 
watch: watch 
вакансия: вакансии 
контакт: контакты 
политика: политика 
конфиденциальность: конфиденциальности 
пользование: пользования 
сайт: сайтом 
выходить: выйти 
ао: ао 
лицензия: лицензия 
