результат: результат результатов результаты 
сбербанк: сбербанк сбербанка 
январь: январю январем январь 
год: год году лет года годом 
изучать: изучить изучаем 
финансовый: финансовых финансовые 
показатель: показатели показателям 
промой: промо 
дарить: дарит 
акция: акции 
регистрация: регистрацию 
мочь: могу 
получать: получить получать получили 
учебник: учебник 
сравнятор: сравнятор 
сообщество: сообщество 
ипотека: ипотека ипотеки 
кредитный: кредитными кредитная кредитный кредитных кредитной 
история: история 
тест: тесты 
дневник: дневники дневник 
трата: трат 
налоговый: налоговые налоговую налоговый 
вычет: вычет 
написать: написать 
инвестиция: инвестиции инвестициями 
бизнес: бизнес бизнеса 
разбор: разборы 
закон: законов 
калькулятор: калькуляторы 
путешествие: путешествия 
медицина: медицина 
здоровье: здоровье 
недвижимость: недвижимость 
подкаста: подкасты 
видео: видео 
смотреть: смотреть 
сервис: сервис сервисы 
расчет: расчеты 
закладка: закладки 
письмо: письма 
оставаться: остается оставайтесь 
деньги: деньгами деньги денег 
поток: потоки 
новость: новости 
инвестор: инвесторы инвестор инвесторов 
прибыль: прибыль 
продолжать: продолжает 
расти: растут расти 
сбер: сбер 
банк: банк банке 
sber: sber 
р: р 
купить: купить 
партнерство: партнерстве 
тинькофф: тинькофф 
котировка: котировки 
обновляться: обновляются 
минута: минут 
лидировать: лидирует 
банковский: банковской 
сфера: сфере 
россия: россии 
масштаб: масштабам 
деятельность: деятельности 
диверсификация: диверсификации 
другой: другим 
существенно: существенно 
оптимизировать: оптимизировал 
затрата: затраты 
например: например 
месяц: месяце месяц месяцев 
сокращать: сократил 
количество: количество 
офис: офисов 
несмотря: несмотря 
жесткий: жесткие 
санкция: санкции 
суметь: сумел 
адаптироваться: адаптироваться 
происходить: происходящему происходящего происходит 
пообещать: пообещал 
рассматривать: рассмотреть 
возможность: возможность 
дивидендный: дивидендных 
выплата: выплат 
февраль: февраля 
отчитываться: отчитался 
рпбу: рпбу 
вадим: вадим 
кизимов: кизимов 
частный: частный 
профиль: профиль 
автор: автора 
курс: курсе курс 
общаться: общаться 
понимать: понимать 
друг: друг друга 
бесплатный: бесплатный 
бережно: бережно 
окружающий: окружающими 
часто: чаще 
желать: желаемое 
общий: общего общие 
клиентский: клиентская 
активность: активность активностью 
вырастать: вырос выросли выросла 
все: всем 
категория: категориям 
активный: активные 
физический: физических физические 
лицо: лиц лица 
рост: рост 
тысяча: тысяч 
юридический: юридических юридические 
пользователь: пользователи пользователей 
обслуживать: обслуживает 
свыше: свыше 
млн: млн 
около: около 
организация: организация организаций 
уменьшаться: уменьшились 
соответственно: соответственно 
отчет: отчете отчет 
такой: такого такое 
падение: падение 
объясняться: объясняется 
сезонный: сезонной сезонная 
который: который которой которых которые которая 
традиционно: традиционно 
высоко: выше 
декабрь: декабре декабрем декабрю 
кредитование: кредитования 
кредит: кредитов кредиты 
резерв: резервов 
снижаться: снизились 
начинать: начала 
отношение: отношение отношению 
оказываться: оказались окажется 
снижение: снижения снижение 
объяснять: объясняют 
погашение: погашением 
рядом: рядом 
крупный: крупных крупнейший 
корпоративный: корпоративных 
клиент: клиентов 
показывать: показали 
прирост: прирост 
совокупный: совокупный 
портфель: портфель 
превышать: превысил 
трлн: трлн 
рубль: рублей 
отмечаться: отмечается отмечаются 
выдача: выдачи 
ипотечный: ипотечных 
сравнение: сравнению сравнении 
предыдущий: предыдущим предыдущего 
повышение: повышение 
объем: объемов 
целое: целом 
качество: качество 
высокий: высокая высокие высоким 
просрочивать: просроченные 
задолженность: задолженности 
составлять: составить составила составляют составило 
лишь: лишь 
ключевой: ключевым ключевые 
операционный: операционным операционные 
млрд: млрд 
изменение: изменение 
чистый: чистая чистый 
процентный: процентный 
доход: доходам доход 
комиссионный: комиссионный 
расход: расходов расходы 
налог: налога налог налоги 
источник: источник 
стр: стр 
отмечать: отмечен 
число: числе 
рентабельность: рентабельность 
актив: активов 
стоимость: стоимость стоимости 
риск: риска риски 
увеличиваться: увеличилась 
это: это 
хороший: лучшие хороший 
учитывать: учитывая 
банка: банка 
начало: начале 
прошлое: прошлом прошлого 
правда: правда 
зарабатывать: заработал 
мало: меньше 
оправдывать: оправдывает 
подчеркивать: подчеркивает 
достигать: достиг 
этот: этих 
использование: использования 
послабление: послаблений 
сторона: стороны 
цб: цб 
рф: рф 
достижение: достижения 
перспектива: перспективы 
отдельно: отдельно 
становиться: стало 
известно: известно 
период: период 
частность: частности 
бренд: брендов бренд 
признавать: признал признали 
самый: самым самых 
дорогой: дорогих дорогим 
сильный: сильным 
среди: среди 
мир: мира 
рейтинг: рейтинге 
brand: brand 
finance: finance 
global: global 
входить: вошел 
топ: топ 
поиск: поиска 
работа: работы 
привлекательный: привлекательным 
рабочий: рабочим 
место: местом мест 
доля: доля доли 
рынок: рынке 
карта: картой картами карт 
сам: саму 
массовый: массовых 
премия: премии 
frank: frank 
credit: credit 
cards: cards 
award: award 
приложение: приложение 
удобный: удобным 
указывать: указывает 
поддержание: поддержание 
значение: значения 
российский: российским российском 
международный: международном 
условие: условиях 
санкционный: санкционного 
давление: давления 
способный: способна 
развиваться: развиваться 
повышать: повышать 
удобство: удобство 
увеличивать: увеличивать 
итог: итоге 
соответствовать: соответствует 
ранее: ранее 
образовываться: образовавшейся 
прибыльный: прибыльной 
тенденция: тенденции 
вероятно: вероятно 
убеждаться: убедились 
возвращение: возвращении 
менее: менее 
отчетность: отчетность отчетности 
положение: положениям 
бухгалтерский: бухгалтерского 
учет: учета 
ряд: ряд 
недостаток: недостатков 
заявлять: заявил 
март: марта 
опубликовывать: опубликует 
мсфо: мсфо 
кроме: кроме 
стоять: стоит 
забывать: забывать 
добровольный: добровольном 
взнос: взносе 
минфин: минфин 
планировать: планирует 
вводить: ввести 
компания: компаний 
сверхдоход: сверхдоходами 
возможно: возможно 
список: списке 
выход: выхода 
упасть: упали 
фон: фоне 
индекс: индекса 
мосбиржа: мосбиржи 
касаться: касаются 
наш: нашем 
подписываться: подписывайтесь 
тэг: тэги 
фотография: фотография 
обложка: обложке 
bxtt: bxtt 
shutterstock: shutterstock 
комментарий: комментарии 
проходить: проходят 
модерация: модерацию 
правило: правилам правила 
журнал: журнала 
boris: boris 
barista: barista 
герой: герой 
оптимизация: оптимизация 
сбербанковски: сбербанковски 
запас: запаса 
вперед: вперед 
серьезно: серьезно 
взгляд: взгляд 
далеко: дальше 
должный: должна 
население: население 
беднеть: беднеет 
берет: берет 
также: также 
квартира: квартир 
сильно: сильно 
размер: размер 
отвечать: ответить 
мошенник: мошенникам 
понадобиться: понадобились 
справка: справки 
репетитор: репетитор 
полагаться: полагался 
каникулы: каникулы 
платить: платил 
человек: человеку человек 
инвалидность: инвалидностью 
копить: копить 
покупать: покупать 
балл: баллы 
уведомлять: уведомлять 
счет: счет счетах 
белоруссия: белоруссии 
работник: работник 
поставлять: поставлять поставить 
товар: товары 
работодатель: работодателю 
ипать: ип 
молодой: молодой 
хотеть: хочет 
оформлять: оформить 
машина: машину 
какой: какие 
быть: будут 
сотрудничать: сотрудничают 
иностранный: иностранным 
сосед: соседи 
заливать: залили 
дверной: дверную 
ручка: ручку 
замок: замок 
клей: клеем 
протест: протест 
ремонт: ремонта 
завещание: завещание 
ребенок: дети детей 
муж: мужа 
имущество: имущество 
здание: здание 
баланс: баланс 
рассказывать: расскажите 
проблема: проблемы проблеме 
багаж: багажом 
возникать: возникали 
поездка: поездках 
косметичка: косметичка 
уход: уход 
чувствительный: чувствительной 
комбинированный: комбинированной 
кожа: кожей 
акна: акне 
последствие: последствия 
покупатель: покупателя 
продавец: продавец 
вносить: внесет 
сколько: сколько 
вернуть: вернуть 
обучение: обучение 
отрабатывать: отработала 
срок: срок 
целевой: целевому 
договор: договор договору 
процент: проценты 
популярный: популярное 
неделя: неделю 
посылка: посылка 
застревать: застряла 
таможня: таможне 
делать: делать 
стаут: стауты 
гоза: гозе 
ламбик: ламбики 
пить: пить 
крафтовый: крафтовое 
пиво: пиво 
москва: москве 
жить: живет 
бали: бали 
зарплата: зарплатой 
въезд: въезда 
сербия: сербию 
россиянин: россиян 
мнение: мнение 
поколение: поколение 
девяностый: девяностых 
лишний: лишнее 
труд: труда 
беспроводный: беспроводные 
колонка: колонки 
удачный: удачных 
модель: моделей 
директор: директор 
розничный: розничной 
сеть: сети 
поволжье: поволжье 
экономист: экономист 
дежурный: дежурный 
электромонтер: электромонтер 
новосибирск: новосибирске 
несколько: несколько 
тратить: тратила 
классный: классные 
впечатление: впечатления 
apple: apple 
watch: watch 
вакансия: вакансии 
сообщать: сообщить 
проект: проекте 
контакт: контакты 
политика: политика 
конфиденциальность: конфиденциальности 
пользование: пользования 
сайт: сайтом 
выходить: выйти 
ао: ао 
лицензия: лицензия 
