краткосрочный: краткосрочных краткосрочные 
облигация: облигация облигаций облигацию облигации 
который: которая которые 
приносить: принесут 
инвестор: инвестор инвестора инвестору инвесторов 
сопоставимый: сопоставимую 
вклад: вкладу вкладов вклад вклады вкладами 
доходность: доходностью доходность доходностей 
промой: промо 
увеличивать: увеличьте 
доход: доходы дохода доход 
сообщество: сообществом сообщество 
это: это 
работать: работает работают 
учебник: учебник 
сравнятор: сравнятор 
ипотека: ипотека 
кредитный: кредитная кредитный кредитным 
история: история 
тест: тесты 
дневник: дневники дневник 
трата: трат 
налоговый: налоговые налоговую налоговый 
вычет: вычет 
написать: написать 
инвестиция: инвестиции инвестициях 
бизнес: бизнес бизнеса бизнесом 
разбор: разборы 
закон: законов 
калькулятор: калькулятор калькуляторы 
путешествие: путешествия 
медицина: медицина 
здоровье: здоровье 
недвижимость: недвижимость 
подкаста: подкасты 
видео: видео 
смотреть: смотреть 
сервис: сервисы 
расчет: расчеты расчетах 
закладка: закладки 
письмо: письма 
оставаться: оставшихся останешься оставайтесь 
деньги: деньгами деньги денег 
поток: потоки 
инвестразбор: инвестразборы 
интересный: интереснее 
какой: какие 
прикупать: прикупить 
портфель: портфель 
мочь: могут 
помогать: помогает помогло помочь 
вкладывать: вложить 
знать: знает знают 
приобретать: приобрести 
именно: именно 
ситуация: ситуации 
присматриваться: присмотритесь 
наш: нашем нашему наших 
список: список списку 
отбирать: отобрали 
бумага: бумаге бумаги 
компания: компании компанию компаний компания 
высокий: высоким 
рейтинг: рейтингом рейтинг 
хороший: хорошей лучшие лучшее 
становиться: стать станет 
альтернатива: альтернативой 
цена: цен цене цены 
упасть: упадут упасть 
помнить: помните 
покупать: покупать покупаете 
лимитный: лимитные 
заявка: заявки 
иначе: иначе 
совершать: совершить 
сделка: сделку 
невыгодный: невыгодной 
получать: получить получаю получать получила получили получил получаете 
меньший: меньшую 
конечный: конечную 
учитывать: учтены 
налог: налогов налога налог налоги 
комиссия: комиссию комиссия 
брокер: брокеру брокера 
сергей: сергей 
шаболкин: шаболкин 
частный: частный 
профиль: профиль 
автор: автора 
делать: делать 
неделя: неделю 
ваш: вашей 
почта: почте 
каждый: каждый 
понедельник: понедельник 
бесплатно: бесплатно 
подписываться: подписаться подписывайтесь 
химический: химическая 
промышленность: промышленность 
годовой: годовых 
погашение: погашения погашение 
тариф: тарифа тарифе 
срок: срок 
день: дня дней 
июль: июля июле 
год: год лет году года 
ruaa: ruaa 
вероятность: вероятность 
дефолт: дефолта 
горизонт: горизонте 
тинькофф: тинькофф 
заниматься: занимается 
крупный: крупных крупнейших 
российский: российскому российских российским 
производитель: производителей 
минеральный: минеральных 
удобрение: удобрений удобрения 
финансы: финансами 
предстоять: предстоит 
погасить: погасить 
обязательство: обязательства 
млрд: млрд 
рубль: рублях рублей рубля 
август: августа августе 
публиковать: публиковала 
отчетность: отчетность отчетности 
международный: международным 
стандарт: стандартам 
момент: момента 
выход: выхода 
релиз: релиза 
свежий: свежие 
данные: данные 
информативность: информативность 
вызывать: вызывает 
вопрос: вопросы 
например: например 
итог: итогам 
чистый: чистой чистая чистую 
прибыль: прибыли прибыль 
рсба: рсбу 
составлять: составляет составить составила составляла 
мсфо: мсфо 
последний: последней последнего последний 
месяц: месяца месяцев 
июнь: июнь июня 
эмитент: эмитента 
объем: объема объемов объем объемы 
счет: счет счета счетах 
финансовый: финансовых финансовые 
вложение: вложения вложениях 
середина: середине 
прошлое: прошлого прошлому 
уровень: уровне 
плюс: плюсы 
ключевой: ключевые 
добывать: добывает добывающие 
производственный: производственные 
актив: активы активов 
располагать: расположены 
россия: россии 
благодаря: благодаря 
дешевый: дешевому 
газ: газу 
рабочий: рабочей 
сила: силе 
удаваться: удается 
удерживать: удерживать 
себестоимость: себестоимость 
низкий: низкая низких низком 
рейтинговый: рейтинговое 
агентство: агентство 
считать: считает считать считают 
должный: должны 
экспорт: экспорта 
предположительно: предположительно 
сохраняться: сохранились 
рост: роста 
минус: минус минусе минусы 
сектор: сектор 
повлиять: повлияют повлиять 
экспортный: экспортные 
пошлина: пошлины 
вводить: ввели 
конец: конца 
правительство: правительстве правительству 
необходимо: необходимо 
восполнять: восполнять 
дефицит: дефицит 
бюджет: бюджета бюджет 
также: также 
выплата: выплаты 
одноразовый: одноразового 
ранее: ранее 
подтвердить: подтвердили 
обсуждать: обсуждают 
вариант: вариант 
взнос: взносами 
прибыльный: прибыльных 
риск: риска риски 
поздний: поздних 
выпуск: выпуска выпусков 
использовать: использовать 
нефтяной: нефтяные нефтяная 
отрасль: отрасли отрасль 
буровой: буровая 
строить: строит строить 
ремонтировать: ремонтирует 
газовый: газовые 
скважина: скважины 
разведывать: разведывать 
месторождение: месторождений месторождения 
углеводород: углеводородов 
сентябрь: сентября 
выходить: выйти вышел 
отчет: отчета отчету отчет 
находиться: находилось 
предшествующий: предшествующий 
выручка: выручки выручка выручку 
операционный: операционную операционной 
размер: размере 
участок: участках 
недра: недр 
федеральный: федерального 
значение: значения 
новый: новым новых 
конкурент: конкурентам 
попадать: попасть 
крайне: крайне 
сложно: сложно 
долговой: долговая 
нагрузка: нагрузка 
покрывать: покрыть 
тело: тело 
долг: долга долгами 
исторически: исторически 
⅔: ⅔ 
приходиться: приходится придется приходиться 
контракт: контракты 
пойти: пойдете пойти пойдет 
серьезно: серьезно 
пострадать: пострадать 
кроме: кроме 
период: периоды 
кризис: кризисам кризисов 
нефтяник: нефтяники 
сокращать: сокращают 
разработка: разработку 
ударять: ударить 
аналитик: аналитики 
говорить: говорят говоря 
нуждаться: нуждается 
заказ: заказах заказов 
услуга: услугах 
значит: значит 
прочность: прочности 
союз: союза 
сомневаться: сомневаться 
страхование: страхование 
rua: rua 
сдавать: сдает 
лизинг: лизинг 
легковой: легковой 
грузовой: грузовой 
транспорт: транспорт 
входить: входит 
группа: группу 
зарабатывать: зарабатывает заработать заработала 
преимущественно: преимущественно 
страховой: страховом 
рынок: рынок рынке рынка 
предыдущий: предыдущие 
часть: часть 
иностранный: иностранных иностранным 
лизингодатель: лизингодателей 
уходить: ушла 
местный: местных 
смочь: смогла 
адаптироваться: адаптироваться 
реалия: реалиям 
игрок: игроков 
означать: означает 
ослабление: ослабление 
конкуренция: конкуренции 
давать: дают дает 
возможность: возможность 
расширять: расширить 
доля: доли долю 
основное: основном 
малый: малым 
средний: средним 
небольшой: небольшие 
обычно: обычно 
чувствительный: чувствительны чувствительной 
экономический: экономической экономическим 
идти: идти 
сокращение: сокращение 
персонал: персонала 
строительство: строительство 
март: марте марта 
rubbb: rubbb 
жилой: жилую 
коммерческий: коммерческую 
облигационный: облигационного 
дата: дату 
процент: процентов проценты 
рука: руку 
девелопера: девелоперам 
госпрограмма: госпрограммы 
стимулирование: стимулирования 
строительный: строительной 
льготный: льготная 
поддерживать: поддержала 
спрос: спрос 
застройщик: застройщикам 
накапливать: накопить 
дополнительный: дополнительные 
долгов: долгов 
отраслевой: отраслевые 
опрашивать: опрошенные 
цикл: цикл 
ставка: ставок 
заканчиваться: заканчивается 
новостройка: новостроек 
перетекать: перетечет 
вторичный: вторичную 
охлаждать: охладили 
мобилизация: мобилизация 
отъезд: отъезд 
россиянин: россиян 
рубеж: рубеж 
концентрация: концентрация 
единственный: единственном 
регион: регионе 
польза: пользу 
хотя: хотя 
начинать: начала 
москва: москве 
сильно: сильно 
зависеть: зависит зависят 
металлургический: металлургическая 
гмк: гмк 
никель: никель 
доллар: долларах 
premium: premium 
апрель: апреля 
ruaaa: ruaaa 
xs: xs 
производить: производит 
высокосортный: высокосортный 
палладий: палладий 
прочий: прочие 
цветной: цветные 
металл: металлы металлов 
разный: разной 
редкость: редкости 
выручать: выручил 
трлн: трлн 
нужно: нужно 
позволять: позволить 
спокойно: спокойно 
расплачиваться: расплатиться 
текущий: текущими 
расход: расходы 
номинировать: номинированы 
защищать: защищена 
девальвация: девальвации 
сша: сша 
великобритания: великобритания 
санкция: санкции 
против: против 
один: одного 
акционер: акционеров 
сам: саму 
ограничение: ограничения 
налагать: наложили 
сырьевой: сырьевых 
ценовой: ценовой 
конъюнктура: конъюнктуры 
тот: та 
очередь: очередь 
определяться: определяется 
активность: активностью 
мир: мире 
замедление: замедление 
падение: падение 
экономика: экономик 
страна: стран 
повлечь: повлечь 
снижение: снижение 
производство: производства 
закупка: закупок 
экспортер: экспортеров 
главный: главный 
покупка: покупки покупкой покупку 
нужный: нужен 
статус: статус 
квалифицированный: квалифицированного 
новость: новости 
касаться: касаются 
курс: курсе 
происходить: происходящего 
тэг: тэги 
фотография: фотография 
обложка: обложке 
skynext: skynext 
shutterstock: shutterstock 
видеть: вижу видишь видите 
смысл: смысл 
инвестировать: инвестировать 
комментарий: комментарии 
проходить: проходят 
модерация: модерацию 
правило: правилам правила 
журнал: журнала 
bmo: bmo 
герой: герой 
остаток: остаток 
накопительный: накопительного 
тинька: тиньке 
приложение: приложение 
памятник: памятник 
светлый: светлому 
зайти: зайти 
туда: туда 
порефлексировать: порефлексировать 
заблокировать: заблокированных 
вздыхать: вздохнуть 
забывать: забыть 
рф: рф 
страшный: страшный 
сон: сон 
отвечать: ответить 
karl: karl 
hungus: hungus 
согласный: согласен 
целое: целом 
все: всё 
менструальный: менструальные 
чаша: чаши 
котиков: котиков 
ага: ага 
еще: ещё 
некст: некст 
леветь: левел 
обзор: обзоры 
мордобойный: мордобойного 
спорт: спорта 
artem: artem 
понимать: понимаю 
брать: беру брать 
инфляция: инфляции 
ay: ay 
жить: жить живет 
депозит: депозит 
копейка: копейки 
нехорошо: нехорошо 
константин: константин 
дьяченко: дьяченко 
отредактировать: отредактировано 
открывать: открываете 
иис: иис 
немой: нем 
купонный: купонного 
возврат: возврат 
ндфл: ндфл 
купить: купить 
дешево: дешевле 
номинал: номинала 
киселев: киселев 
замораживать: заморозить 
далеко: далеко дальше 
планировать: планирую 
очень: очень 
тимур: тимур 
идея: идей идея 
отсутствие: отсутствии 
другой: других 
подумать: подумать 
наличие: наличии 
системообразующий: системообразующих 
банк: банк банках 
кой: кой 
ляд: ляд 
облиг: облиги 
ниже: ниже 
андрей: андрей 
репкин: репкин 
втб: втб 
откуда: откуда 
такой: такая 
щедрость: щедрость 
ммм: ммм 
юрий: юрий 
рузавин: рузавин 
странный: странная 
подборка: подборка 
самый: самых 
банально: банально 
среднее: среднем 
вдо: вдо 
реклама: рекламу 
трейдер: трейдер 
премиум: премиум 
тиньков: тинькова 
maximponomaryov: maximponomaryov 
высоко: выше 
надежный: надежные 
гк: гк 
понравиться: понравились 
сиеть: сиеть 
ом: ом 
разница: разницу 
наталья: наталья 
федоров: федорова 
гладко: гладко 
дело: деле 
платить: платил плати 
короче: короче 
мошенник: мошенникам 
понадобиться: понадобились 
справка: справки 
репетитор: репетитор 
полагаться: полагался 
каникулы: каникулы 
человек: человеку человек 
инвалидность: инвалидностью 
копить: копить 
балл: баллы 
уведомлять: уведомлять 
белоруссия: белоруссии 
работник: работник 
поставлять: поставлять поставить 
товар: товары 
работодатель: работодателю 
ипать: ип 
молодой: молодой 
хотеть: хочет 
оформлять: оформить 
машина: машину 
быть: будут 
сотрудничать: сотрудничают 
сосед: соседи 
заливать: залили 
дверной: дверную 
ручка: ручку 
замок: замок 
клей: клеем 
протест: протест 
ремонт: ремонта 
завещание: завещание 
ребенок: дети детей 
муж: мужа 
имущество: имущество 
стоимость: стоимости 
здание: здание 
баланс: баланс 
рассказывать: расскажите 
проблема: проблемы проблеме 
багаж: багажом 
возникать: возникали 
поездка: поездках 
косметичка: косметичка 
уход: уход 
комбинированный: комбинированной 
кожа: кожей 
акна: акне 
последствие: последствия 
покупатель: покупателя 
продавец: продавец 
вносить: внесет 
сколько: сколько 
вернуть: вернуть 
обучение: обучение 
отрабатывать: отработала 
целевой: целевому 
договор: договор договору 
популярный: популярное 
посылка: посылка 
застревать: застряла 
таможня: таможне 
стаут: стауты 
гоза: гозе 
ламбик: ламбики 
место: мест 
пить: пить 
крафтовый: крафтовое 
пиво: пиво 
бали: бали 
зарплата: зарплатой 
въезд: въезда 
сербия: сербию 
мнение: мнение 
поколение: поколение 
девяностый: девяностых 
лишний: лишнее 
труд: труда 
беспроводный: беспроводные 
колонка: колонки 
удачный: удачных 
модель: моделей 
директор: директор 
розничный: розничной 
сеть: сети 
поволжье: поволжье 
экономист: экономист 
дежурный: дежурный 
электромонтер: электромонтер 
новосибирск: новосибирске 
несколько: несколько 
тратить: тратила 
классный: классные 
впечатление: впечатления 
apple: apple 
watch: watch 
вакансия: вакансии 
сообщать: сообщить 
проект: проекте 
контакт: контакты 
политика: политика 
конфиденциальность: конфиденциальности 
пользование: пользования 
сайт: сайтом 
ао: ао 
лицензия: лицензия 
