купить: купить 
акция: акциями акция акции акциям акций 
headhunter: headhunter 
group: group 
plc: plc 
стоимость: стоимость 
сегодня: сегодня 
прогноз: прогноз 
цена: цен цена 
котировка: котировками котировки 
график: графике графиками 
динамика: динамика динамику 
курс: курса 
онлайн: онлайн 
банк: банк банке банком 
бизнес: бизнес бизнеса 
касса: касса кассы 
инвестиция: инвестиции 
страхование: страхование 
путешествие: путешествия 
город: город 
доля: доля долями 
входить: войти войдите 
обзор: обзор 
каталог: каталог 
пульс: пульс пульсе 
аналитика: аналитика 
академия: академия 
скринер: скринер 
терминал: терминал 
hhr: hhr 
доходность: доходность 
полгода: полгода 
сектор: секторе сектора сектору сектор 
потребительский: потребительские 
товар: товары 
услуга: услуг услуги 
новость: новости новостях 
компания: компании компания компаний 
предоставлять: предоставляет 
персонал: персонала 
нацеливать: нацелена 
объединение: объединение 
соискатель: соискателей 
работа: работу работы работа 
работодатель: работодателями работодателям 
иметься: имеются 
такой: такие таких 
сервис: сервисы 
сайт: сайте сайты сайт 
приложение: приложения 
обширный: обширной 
база: базой 
данный: данную данных 
который: которой которые 
миллион: миллионов 
резюме: резюме 
обслуживать: обслуживает 
клиент: клиентов клиентами 
россия: россия россии 
страна: страну страна странах стране 
снг: снг 
биржа: биржа бирже 
торги: торги торгов 
спб: спб 
сводный: сводный 
прогнозный: прогнозная 
диапазон: диапазон 
рекомендация: рекомендацией рекомендация 
покупать: покупать 
показатель: показатели показателей 
торговый: торговый торговые 
данные: данные 
параметр: параметры 
бумага: бумагами бумаги бумаг бумагу бумагам 
открытие: открытия 
закрытие: закрытия 
дневной: дневной 
изменение: изменение 
день: днем день 
год: год лет году года 
годовой: годовой 
код: код 
идентификатор: идентификатор 
режим: режима 
spbxm: spbxm 
isin: isin 
лотность: лотность 
лот: лот 
квалифицированный: квалифицированных 
инвестор: инвесторов 
валюта: валют валюта 
usd: usd 
интересный: интересное 
пост: посты 
февраль: февраля 
устраиваться: устроиться 
тинькофф: тинькофф 
аналитик: аналитики 
обнаруживать: обнаружили 
резкий: резкий 
всплеск: всплеск 
интерес: интерес интереса 
вакансия: вакансий вакансиям вакансии 
удаленка: удаленка удаленкой 
объявлять: объявлена 
частичный: частичная 
мобилизация: мобилизация 
удаленный: удаленная 
становиться: стал стала 
актуальный: актуальна 
покидать: покинувших 
мужчина: мужчин 
женщина: женщин 
оставаться: остались 
ребенок: детьми 
рука: руках 
призыв: призыва 
свой: свои своих 
муж: мужей 
работать: работающих работает работающая 
дистанционно: дистанционно 
предлагать: предлагает 
дома: дома 
среди: среди 
требовать: требующие 
опыт: опыта 
все: всем всё 
обучение: обучение 
проводиться: проводиться проводится 
внутри: внутри 
банка: банка 
доступно: доступно 
несколько: несколько нескольких 
пригождаться: пригодилось 
доход: доход 
псвп: псвп 
заработок: заработок 
заработоквинтернет: заработоквинтернете 
tcsg: tcsg 
часть: часть 
posi: posi 
группа: группы группа 
позитив: позитив 
стремительно: стремительно 
расти: растущая 
сфера: сфере 
кибербезопасность: кибербезопасности 
выручка: выручки выручка выручку 
итог: итогам 
iii: iii 
квартал: квартал квартале квартала 
г: г 
вырастать: выросли выросла вырастет 
млрд: млрд 
руб: руб 
месяц: месяцы месяцев 
составлять: составляет составила 
продемонстрировать: продемонстрировав 
рост: роста рост 
сравнение: сравнению 
аналогичный: аналогичным 
период: периодом 
прошлое: прошлого 
темп: темпам темпы темпами 
продажа: продажи продаж 
ключевой: ключевым 
продукт: продуктов продуктам 
превышать: превысили 
драйвер: драйверов драйвером 
уход: уход 
многий: многих 
зарубежный: зарубежных 
игрок: игроков 
российский: российского российских российском 
рынок: рынке рынка 
также: также 
продолжаться: продолжающийся 
органический: органический 
раз: раза 
показывать: показав 
хороший: лучших 
результат: результатах результатов 
средне: средне 
долгосрочный: долгосрочной долгосрочные 
ожидание: ожидания 
позитивный: позитивные 
выглядеть: выглядит 
дорого: дорого 
мультипликатор: мультипликаторам 
однако: однако 
это: этим это 
обусловливать: обусловлено 
фундаментальный: фундаментальными 
вводный: вводными 
высокий: высокие высокая высокими высоким 
очень: очень 
нравиться: нравится 
мочь: могу можете могут 
отмечать: отметить 
аудитория: аудиторию 
держать: держать 
smlt: smlt 
самолет: самолета самолет 
девелопмент: девелопмента 
операционный: операционных 
демонстрировать: демонстрирует 
рамка: рамках 
предварительный: предварительных 
оценка: оценок 
управленческий: управленческой 
отчетность: отчетности 
ожидать: ожидает 
увеличиваться: увеличится 
ebitda: ebitda 
стоять: стоит 
продолжать: продолжала 
выплачивать: выплачивать 
дивиденд: дивиденды дивидендов 
отличие: отличие 
остальной: остальными остальных 
крупный: крупных крупные 
девелоперов: девелоперов 
ускорение: ускорения 
план: планах 
наращивать: нарастить 
увеличивать: увеличить 
достигать: достигнет 
текущий: текущих 
опережать: опережать 
конкурент: конкурентов 
перспектива: перспективе перспективах 
благодаря: благодаря 
hhru: hhru 
лидировать: лидирующие лидирующая 
рекрутинговый: рекрутинговых 
последний: последние 
отставать: отстают 
отраслевой: отраслевые отраслевых 
дело: дело 
чувствительный: чувствителен 
макроэкономический: макроэкономической 
ситуация: ситуации ситуация 
событие: события 
снижать: снизили 
уверенность: уверенность 
развитие: развития 
заставлять: заставили 
консервативно: консервативно 
подходить: подходить 
набор: набору 
негативно: негативно 
сказываться: сказаться 
финансовый: финансовых финансового финансовый 
связь: связи 
среднесрочный: среднесрочные 
сдержанный: сдержанные 
отчет: отчета отчет 
iv: iv 
слабый: слабым 
время: время 
многое: многом 
закладывать: заложено 
поэтому: поэтому 
шанс: шансы 
увидеть: увидеть 
догонять: догоняющий 
должный: должна 
постепенно: постепенно 
стабилизироваться: стабилизироваться 
сильный: сильные 
сторона: стороны 
рентабельность: рентабельность 
позиция: позиции 
mdmg: mdmg 
гк: гк 
дитя: дитя 
здравоохранение: здравоохранения 
масштаб: масштабов 
обеспечиваться: обеспечивается 
строительство: строительство строительством 
новый: новых 
клиника: клиник 
госпиталь: госпиталей 
региональный: региональной 
экспансия: экспансией 
загрузка: загрузкой 
существовать: существующих 
мощность: мощностей 
лишь: лишь 
счет: счет счета счетов 
дозагрузка: дозагрузки 
создавать: созданных 
вдвое: вдвое 
замедляться: замедлиться 
заморозок: заморозки 
инвестпрограмма: инвестпрограммы 
неопределенность: неопределенностью 
менее: менее 
стабилизация: стабилизации 
вновь: вновь 
начинать: начать начала 
умеренно: умеренно 
отсутствие: отсутствие 
вернуться: вернуться 
публикация: публикации 
апрель: апреля 
иир: иир 
новичок: новичкам 
spbexchange: spbexchange 
проведение: проведении 
официальный: официальный официальным 
нерабочий: нерабочим 
биржевой: биржевых 
площадка: площадках 
быть: будут 
расчет: расчеты 
ценный: ценными ценную ценные 
первичный: первичным 
листинг: листингом листинга 
сша: сша 
число: числе 
иностранный: иностранными 
etf: etf 
проходить: проходить прошло 
согласно: согласно 
стандартный: стандартному 
расписание: расписанию 
мск: мск 
начинаться: начнутся 
гонконг: гонконга 
казмунайгаз: казмунайгаз 
tcs: tcs 
holding: holding 
fix: fix 
price: price 
yandex: yandex 
ozon: ozon 
cian: cian 
x: x 
retail: retail 
эмитент: эмитентов 
какой: какие каких 
избавляться: избавлялись 
акционер: акционеры 
фондовый: фондовом 
сделка: сделку сделка сделок 
qiwi: qiwi 
энерго: энерго 
рассказывать: расскажу 
подробно: подробнее 
каждый: каждую 
тестировать: тестировать 
специальный: специальные 
бейджи: бейджи 
трудоустройство: трудоустройства 
инструмент: инструмент 
позволять: позволит 
пользователь: пользователям 
выделять: выделить 
быстро: быстрее 
находить: найти находить 
кандидат: кандидатов 
кремль: кремле 
планировать: планируют 
находиться: находятся 
замораживать: замороженные 
актив: активы активов актива 
дайджест: дайджест 
сколько: сколько 
сбербанк: сбербанк 
зарабатывать: заработал заработали 
январь: январе января 
бороться: борется 
сохранение: сохранение 
лондон: лондоне 
сделать: сделал сделали 
воздушный: воздушным 
шар: шаром 
китай: китая 
говорить: говорили 
путин: путин 
лукашенко: лукашенко 
interfax: interfax 
goldman: goldman 
продавать: продал 
бывший: бывшим 
возникать: возник 
временный: временный 
дефицит: дефицит 
краска: красок 
хотеть: хочет 
перевозить: перевозить 
половина: половину 
пассажир: пассажиров 
kismet: kismet 
capital: capital 
иван: ивана 
таврин: таврина 
заплатить: заплатила 
млн: млн 
переставать: перестала 
германия: германия 
зависеть: зависеть 
поставка: поставок 
газ: газа 
втб: втб 
telegram: telegram 
рекомендовать: рекомендует 
частый: частые 
вопрос: вопросы 
еще: ещё 
относиться: относятся 
лента: лента 
русагро: русагро 
физический: физическому физическим 
лицо: лицу лицам 
приобретать: приобрести 
открывать: открыть открыв 
индивидуальный: индивидуальный индивидуальной 
инвестиционный: инвестиционный инвестиционной 
брокерский: брокерский брокерской 
представлять: представленные 
доступный: доступна доступны 
покупка: покупке покупки 
торговля: торговля 
шорты: шорт 
маржинальный: маржинальная 
недоступный: недоступна 
похожий: похожие 
личный: личный 
кабинет: кабинет 
другой: другие 
хэдхантер: хэдхантер 
выпуск: выпуск 
погашение: погашение 
облигация: облигация 
час: часов 
один: одной 
доллар: долларов 
производиться: производится 
лонг: лонг 
ознакомляться: ознакомиться 
отслеживать: отследить 
информация: информация информацию 
размер: размере 
узнавать: узнать 
основной: основных 
влиять: влияющих 
инвестировать: инвестировав 
вложенный: вложенной 
сумма: суммы 
этот: эта 
звонок: звонков 
кредитный: кредитные 
карта: карты 
дебетовый: дебетовые 
премиум: премиум 
кредит: кредит кредиты 
наличные: наличными 
рефинансирование: рефинансирование 
автокредит: автокредит 
вклад: вклады 
платеж: платежи 
подписка: подписка 
pro: pro 
tinkoff: tinkoff 
private: private 
осаго: осаго 
каско: каско 
граница: границу 
ипотека: ипотека 
квартира: квартира 
дом: дом 
здоровье: здоровье 
блог: блог 
авиабилет: авиабилеты 
отель: отели 
тур: туры 
билет: билеты 
лететь: лететь 
малый: малый 
расчетный: расчетный 
регистрация: регистрация 
эквайринг: эквайринг 
госзакупки: госзакупки 
бухгалтерия: бухгалтерия 
депозит: депозиты 
проверка: проверка 
контрагент: контрагентов 
бонус: бонусы 
кино: кино 
театр: театры 
концерт: концерты 
ресторан: рестораны 
доставка: доставка 
салон: салоны 
красота: красоты 
топливо: топливо 
автомобиль: автомобили 
haval: haval 
модель: модели 
jolion: jolion 
f: f 
dargo: dargo 
h: h 
гарантия: гарантия 
большой: большой 
выплата: выплаты выплат 
вэд: вэд 
облачный: облачные 
выставление: выставление 
безналичный: безналичные 
чаевые: чаевые 
решение: решения 
оплата: оплата 
безопасный: безопасная 
карьера: карьера 
процесс: процессы 
иис: иис 
тариф: тарифы 
esim: esim 
перенос: перенос 
номер: номер номера 
роуминг: роуминг 
красивый: красивые 
запись: запись 
виртуальный: виртуальный 
секретарь: секретарь 
олег: олег 
точка: точки 
пополнение: пополнения 
банкомат: банкоматы 
курсы: курсы 
контакт: контакты 
помощь: помощь 
investors: investors 
получатель: получателей 
депонент: депонентов 
являться: является 
ао: ао 
лицензия: лицензия 
осуществление: осуществление 
деятельность: деятельности 
депозитарный: депозитарной 
выдавать: выданы 
ограничение: ограничения 
срок: срока 
действие: действия 
универсальный: универсальная 
цб: цб 
рф: рф 
english: english 
