учебник: учебник 
сравнятор: сравнятор 
сообщество: сообщество 
ипотека: ипотека 
кредитный: кредитная 
история: история истории 
тест: тесты 
дневник: дневники дневник 
трата: трат 
налоговый: налоговый 
вычет: вычет 
написать: написать 
инвестиция: инвестиции 
бизнес: бизнес 
разбор: разборы 
закон: законов 
калькулятор: калькуляторы 
путешествие: путешествия 
медицина: медицина 
здоровье: здоровье 
недвижимость: недвижимость 
подкаста: подкасты 
видео: видео 
смотреть: смотреть смотрит 
сервис: сервисы 
расчет: расчеты 
закладка: закладки 
письмо: письма 
оставаться: оставайтесь 
деньги: деньгами деньги 
поток: потоки 
писать: пишем 
тот: тех 
играть: играть играет 
видеоигра: видеоигры 
кино: кино 
сериал: сериалы сериал сериала 
просто: просто 
любить: любит 
эскапизм: эскапизм 
подсказывать: подсказываем 
тратить: тратить 
время: время 
сэкономить: сэкономить 
михаил: михаил 
городилов: городилов 
взвод: взводе 
битва: битва 
uber: uber 
правда: правда 
неправда: неправда 
ефим: ефим 
гугнин: гугнин 
оса: оса 
квантомания: квантомания 
пересказывать: пересказываем 
сюжет: сюжета сюжет 
сцена: сцены 
титр: титров 
алихан: алихан 
исрапил: исрапилов 
часть: части 
поттер: поттера 
тварь: тварей 
плохой: худшей 
хороший: лучшей лучших лучшим 
почитать: почитать 
увлечение: увлечения 
алексей: алексей 
сигабатулин: сигабатулин 
затягивать: затягивающих 
игра: игр игры 
кто: кому 
хотеться: хочется 
приключение: приключений 
валентин: валентин 
шакун: шакун 
hogwarts: hogwarts 
legacy: legacy 
пересказ: пересказ 
концовка: концовок 
поиграть: поиграть 
роман: роман 
персианин: персианинов 
контент: контент 
планета: планете 
способ: способов 
отлично: отлично 
проводить: провести 
youtube: youtube 
олег: олег 
кубанеишвили: кубанеишвили 
nintendo: nintendo 
уметь: умеет 
консоль: консоль 
стоять: стоит 
покупать: покупать 
влад: влад 
шуравин: шуравин 
русский: русском русского 
хоррор: хоррор хоррора 
красный: красный 
состав: состав 
анимационный: анимационный 
пушкин: пушкину 
толстой: толстому 
семен: семен 
окорок: окороков 
записывать: записывать 
пк: пк 
консоли: консолях 
другой: других другими 
устройство: устройствах 
егор: егор 
аргунов: аргунов 
купить: купить 
atomic: atomic 
heart: heart 
россия: россии 
какой: какую каким 
версия: версию 
выбирать: выбрать 
гюнтер: гюнтера 
документальный: документальный 
культ: культами 
финансовый: финансовыми 
махинация: махинациями 
саша: саша 
кириллов: кириллова 
январь: январь 
год: года 
становиться: стал 
месяц: месяцем 
кинопрокат: кинопроката 
ждать: ждет 
индустрия: индустрию 
далеко: дальше 
редакция: редакция 
необычный: необычную 
статья: статью 
встречать: встречали 
википедия: википедии 
артем: артем 
мазан: мазанов 
российский: российских 
убирать: уберут 
картина: картины 
disney: disney 
включая: включая 
pixar: pixar 
marvel: marvel 
пропадать: пропадет 
выходить: выйти вышел 
новый: новых новый 
создатель: создателя 
лассо: лассо 
трейлер: трейлеры 
джонс: джонса 
показывать: показали показывают 
супербоул: супербоуле 
lvii: lvii 
евгений: евгений 
шепелев: шепелев 
устраивать: устроены 
экономика: экономика 
финансы: финансы 
мир: мира 
гарри: гарри 
ольга: ольга 
щербинина: щербинина 
комикс: комиксов 
язык: языке 
полезный: полезных 
совет: советов 
прохождение: прохождению 
командный: командных 
шутер: шутеров 
который: которые 
друг: друзьями 
пятый: пятый 
сезон: сезон 
странный: странных 
дело: дел 
известно: известно 
почему: почему 
завируситься: завирусился 
даша: даша 
лейзаренко: лейзаренко 
netflix: netflix 
запрещать: запретит 
делиться: делиться 
пароль: паролем 
пользователь: пользователями 
это: это 
работать: работать 
гульназ: гульназ 
давлетшин: давлетшина 
джорджия: джорджия 
дух: духе 
домохозяйка: домохозяек 
скоро: скорее 
красавчик: красавчика 
актер: актеров 
чей: чей 
талант: талант 
знать: знает 
граница: границ 
вакансия: вакансии 
сообщать: сообщить 
проблема: проблеме 
проект: проекте 
контакт: контакты 
политика: политика 
конфиденциальность: конфиденциальности 
правило: правила 
пользование: пользования 
сайт: сайтом 
ао: ао 
банк: банк 
лицензия: лицензия 
