раскрытие: раскрытие раскрытию 
информация: информация информации информацию 
пао: пао 
спб: спб 
биржа: бирж биржей бирже биржи биржа 
spb: spb 
exchange: exchange 
ценный: ценных ценные 
бумага: бумагах бумаги бумаг 
иностранный: иностранных иностранные 
российский: российской российского российским российские 
подключение: подключение 
кабинет: кабинет 
инвестор: инвестора инвестору инвесторы инвесторов инвесторами инвестором 
торговый: торговый 
календарь: календарь 
клиринг: клиринг 
расчет: расчеты 
участник: участникам участниках участниками участники 
документ: документы 
отчетность: отчетность 
технологический: технологические 
решение: решения 
тариф: тарифы 
график: графики 
котировка: котировок 
индекс: индексы 
spbtl: spbtl 
spboaw: spboaw 
spbicar: spbicar 
spbievi: spbievi 
spbifut: spbifut 
spbirec: spbirec 
spbirg: spbirg 
spbirus: spbirus 
spbisec: spbisec 
spbisem: spbisem 
листинг: листинг листинга 
услуга: услуг услугах услуги 
эмитент: эмитентами эмитентов эмитент эмитента эмитентом эмитентам 
список: списках список списка 
сегмент: сегментов сегменты 
требование: требованиям требований требования 
делистинг: делистинг 
публичный: публичному публичное публичного 
размещение: размещение 
биржевой: биржевая биржевые биржевого биржевом 
облигация: облигации 
новость: новости 
приобретение: приобретение приобретением приобретения 
статус: статуса 
контакт: контакты 
рыночный: рыночные 
данные: данные данными 
итог: итогов итоги итогах 
торги: торгах торгам торгов 
архив: архив 
аукцион: аукцион 
закрытие: закрытия 
внебиржевой: внебиржевой внебиржевых 
рынок: рынок рынков рынках рынке рынка 
rts: rts 
board: board 
репозитарий: репозитарий репозитария 
договор: договорах договоров 
отчет: отчеты отчет 
руководство: руководство 
комиссия: комиссии 
комитет: комитеты комитете 
корпоративный: корпоративный 
секретарь: секретарь 
миссия: миссия 
мероприятие: мероприятия 
реквизит: реквизиты 
логотип: логотипы 
вакансия: вакансии 
частный: частному 
учредительный: учредительные 
лицензия: лицензии 
положение: положения положениями положение положении 
орган: органах 
управление: управления 
совет: совете совета 
технический: техническом технических 
развитие: развитию 
пользователь: пользователей 
репозитарный: репозитарных 
внутренний: внутренние внутреннего 
сведение: сведения сведениях 
эмиссия: эмиссии 
общий: общее общего общем общих 
собрание: собрания собраниях собрание 
акционер: акционеров 
внеочередной: внеочередного внеочередное 
декабрь: декабря 
годовой: годовые годовое 
июнь: июня 
ноябрь: ноября 
сентябрь: сентября 
июль: июля 
май: мая 
отмена: отмена 
октябрь: октября 
аффилировать: аффилированных 
лицо: лица лиц лицам лицами лицо лицом лицу 
факт: факты фактах 
раскрывать: раскрываемые 
сообщение: сообщение сообщений сообщении сообщения сообщением 
существенный: существенных 
дополнительный: дополнительных 
уведомление: уведомления уведомление 
иной: иными иных иным иное иные иной 
ежеквартальный: ежеквартальные 
финансовый: финансовых финансовом финансовым финансовая 
бухгалтерский: бухгалтерская 
допускать: допущенных допущены 
порядок: порядок 
направление: направления 
включение: включения включении 
риск: рисках 
связанный: связанных 
ликвидный: ликвидных 
также: также 
низколиквидный: низколиквидных 
фондовый: фондовый фондового 
нарушение: нарушениях нарушение 
совершенный: совершенных 
неисполнение: неисполнении 
обязательство: обязательств 
сделка: сделки сделкам 
сайт: сайте сайта 
мера: мерах меры 
предпринимать: предпринятые 
судебный: судебных 
спор: спорах 
организатор: организатора 
торговля: торговли 
деятельность: деятельностью деятельность 
организация: организации 
дочерний: дочерних 
зависимый: зависимых 
общество: обществ общества общество 
сбой: сбоях 
приостановка: приостановке 
подавать: поданных 
заявление: заявлениях 
допуск: допуске допуск 
организованный: организованным организованных 
изменение: изменения изменениями изменении изменений 
уровень: уровнем уровня 
соответствие: соответствии 
установленный: установленным 
нахождение: нахождения 
котировальный: котировальных 
рентабельность: рентабельности 
капитал: капитала 
акция: акции акций 
данный: данному данным данном данный данных 
мсфо: мсфо 
дивидендный: дивидендной 
доходность: доходности 
введение: введение 
эксплуатация: эксплуатацию 
средство: средств 
проведение: проведения 
количество: количестве 
стоимостный: стоимостном 
объем: объеме 
работа: работы 
период: период 
праздничный: праздничных 
выходной: выходных 
день: дней 
который: которые которой которых которого которым 
приостанавливать: приостановлен 
возобновлять: возобновлен 
расписание: расписание 
осуществлять: осуществляющего осуществляет 
ведение: ведение 
реестр: реестра 
владелец: владельце владельцев 
перечень: перечень 
лист: листов 
политика: политике 
информационный: информационным информационной 
обобщенный: обобщенные 
показатель: показатели 
охрана: охрана 
труд: труда 
рекомендация: рекомендации 
предотвращение: предотвращению 
несанкционированный: несанкционированного 
доступ: доступ доступа 
защищать: защищены защищаемой 
цель: целях 
противодействие: противодействия 
незаконный: незаконным 
операция: операциям 
обращение: обращению 
состояние: состоянии состоянию 
год: года 
составлять: составленный 
исполнение: исполнение 
пункт: пункта 
статья: статьи 
федеральный: федеральный федерального 
закон: закона законов законом закон закону 
внесение: внесении 
отдельный: отдельные 
законодательный: законодательных законодательные 
акт: актов акты 
федерация: федерации 
заключенный: заключенных 
банка: банка 
россия: россии 
страница: странице страницу 
сеть: сети 
интернет: интернет 
предоставлять: предоставленного предоставляемой предоставлена предоставить 
ооо: ооо 
агентство: агентством 
аккредитовать: аккредитованным 
банк: банк банком 
copyright: copyright 
право: права 
аналитический: аналитические 
материал: материалы материалах материалам 
размещать: размещенной размещенные 
настоящий: настоящем настоящим настоящую 
законодательство: законодательством законодательства 
воспроизведение: воспроизведение 
распространение: распространению распространение 
использование: использование 
часть: частью части 
допускаться: допускается 
предварительный: предварительного 
письменный: письменного 
согласие: согласия 
пользовательский: пользовательское 
соглашение: соглашение 
обработка: обработка 
персональный: персональных 
важный: важное 
объявление: объявление 
территория: территорию территории 
определенный: определенных 
страна: страны стран стране 
ограничивать: ограничен 
получать: получить получающие 
необходимо: необходимо 
подтверждать: подтверждаю подтвердить 
являться: являетесь являются являющееся являюсь являющимся является 
гражданин: гражданином 
находиться: нахожусь находитесь 
один: одной 
следовать: следующих 
соединять: соединенном соединенных соединенные 
штат: штата штатах штатов штаты 
америка: америки 
австралия: австралия австралии 
канада: канаде канада канады 
япония: японии япония 
резидент: резидентом 
пожалуйста: пожалуйста 
покидать: покиньте 
приводить: приведенная 
предложение: предложением предложения предложение 
приглашение: приглашения приглашением 
делать: делать 
отношение: отношении 
подписка: подписки 
обыкновенный: обыкновенные 
акционерный: акционерного 
подобный: подобные 
противоречить: противоречат 
частность: частности 
подлежать: подлежат подлежащей подлежит 
продажа: продаже продажа 
быть: будут буду 
зарегистрировать: зарегистрированы 
сша: сша 
дополнение: дополнениями дополнения 
провинция: провинции 
округ: округа 
юрисдикция: юрисдикции 
мочь: могут можем 
предлагать: предложены 
продавать: проданы 
регистрация: регистрации 
основание: основании 
освобождение: освобождения 
рамка: рамках 
осуществляться: осуществляется осуществляться 
содержаться: содержащейся содержащиеся содержащаяся 
направляться: направляется 
адресоваться: адресуется 
европейский: европейской европейского европейском 
экономический: экономической 
зона: зоны 
еэз: еэз 
исключительно: исключительно 
условие: условии условия 
такой: такие такая 
значение: значении 
регламент: регламента 
проспект: проспекте 
союз: союза союзе 
последующий: последующими 
квалифицированный: квалифицированным квалифицированных квалифицированные 
кроме: кроме 
королевство: королевства королевстве 
соединенный: соединенного 
поскольку: поскольку 
сила: силу 
выход: выходе 
иметь: имеющими имеющие 
профессиональный: профессиональный 
опыт: опыт 
вопрос: вопросы вопросах 
относиться: относящихся относятся 
инвестиция: инвестиции инвестициям 
смысл: смыслу 
приказ: приказа приказ 
г: г 
продвижение: продвижении 
продукт: продуктов 
согласно: согласно 
распространяться: распространяется 
действие: действий действие 
высокий: высоким 
доход: дохода 
юридический: юридического 
далее: далее 
указанный: указанные указанная 
правомерный: правомерно 
совместно: совместно 
именоваться: именуются 
соответствующий: соответствующей соответствующим соответствующие 
любой: любую любому любых любые любой любом 
инвестиционный: инвестиционная 
излагать: изложенное изложенные 
доступный: доступны 
соответствовать: соответствующих 
государство: государств 
должно: должно 
совершать: совершать 
полагаться: полагаться 
разрешать: разрешено 
просматривать: просматривать 
сомневаться: сомневаетесь 
обнародование: обнародованию 
опубликование: опубликованию опубликования 
способ: способом 
повлечь: повлекут повлечет 
хранитель: хранителей 
номинальный: номинальных 
держатель: держателей 
доверительный: доверительных 
управлять: управляющих 
должный: должны 
обнародоваться: обнародовать 
опубликовывать: опубликовывать 
распространять: распространять 
подтверждение: подтверждение 
понимание: понимания 
заверять: заверяю 
гарантировать: гарантирую 
образ: образом 
это: это 
местный: местного 
нормативный: нормативных 
прочитывать: прочитал 
понимать: понимаю понял 
высоко: выше 
оно: оно 
повлиять: повлиять 
мой: мои 
согласный: согласен 
соблюдать: соблюдать 
продолжать: продолжать 
принимать: принимаю 
термин: термин 
определять: определен 
актуальный: актуальной 
дата: даты дату 
кой: коем 
случай: случае 
подразумеваться: подразумевается 
верный: верной 
дело: дел 
происходить: произошло 
никакой: никаких 
периодически: периодически 
обновляться: обновляться 
берет: берет 
публиковать: публиковать 
vtb: vtb 
capital: capital 
plc: plc 
ао: ао 
alfa: alfa 
markets: markets 
ltd: ltd 
компания: компания 
финанс: финанс 
bank: bank 
gpb: gpb 
international: international 
корпорация: корпорация 
открытие: открытие 
sova: sova 
limited: limited 
bcs: bcs 
prime: prime 
brokerage: brokerage 
агент: агентов 
сотрудник: сотрудников 
консультант: консультантов 
отвечать: ответьте отвечают 
применимый: применимых 
физический: физическими 
результат: результате 
предоставление: предоставления 
они: ими 
недостоверный: недостоверной 
косвенно: косвенно 
следующий: следующие 
сожаление: сожалению 
раздел: разделу 
наш: нашего 
ограничение: ограничений 
