хороший: лучшие хороший хорошая лучшей лучших хороша хорошего лучшее лучшая 
портативный: портативных портативной портативные портативного портативная 
беспроводный: беспроводные беспроводного 
колонка: колонок колонка колонкой колонках колонку колонки колонке 
цена: ценам цене цены цена 
удобство: удобство 
дизайн: дизайна дизайном дизайн 
качество: качестве качество качества 
звук: звуки звуку звуком звука звук 
какой: какую какие какого 
купить: купил купила купить 
промой: промо 
tinkoff: tinkoff 
platinum: platinum 
лимит: лимитом 
заказывать: заказать 
карта: карту 
учебник: учебник 
сравнятор: сравнятор 
сообщество: сообщество 
ипотека: ипотека 
кредитный: кредитная 
история: история 
тест: тестов тест тесты 
дневник: дневники дневник 
трата: трат 
налоговый: налоговые налоговую налоговый 
вычет: вычет 
написать: написать 
инвестиция: инвестиции 
бизнес: бизнес бизнеса 
разбор: разборы 
закон: законов 
калькулятор: калькуляторы 
путешествие: путешествие путешествия 
медицина: медицина 
здоровье: здоровье 
недвижимость: недвижимость 
подкаста: подкасты 
видео: видео 
смотреть: смотрят смотреть 
сервис: сервисы 
расчет: расчеты 
закладка: закладки 
письмо: письма 
оставаться: оставались оставайтесь 
деньги: деньгами деньги денег 
поток: потоки 
удачный: удачных 
модель: модель модели моделей моделями 
даниил: даниил 
баздырев: баздырев 
знать: знает 
зажигать: зажечь 
вечеринка: вечеринку вечеринки вечеринок 
профиль: профиль 
автор: автора авторы автор 
акустика: акустики акустика акустику 
пригождаться: пригодится 
дома: дома 
природа: природе природу природы 
легко: легко 
подключаться: подключается 
смартфон: смартфонов смартфону смартфон смартфона 
компьютер: компьютера компьютеру 
провод: проводов 
долго: долго 
работать: работать работает 
розетка: розетки 
многие: многие многим 
бояться: боятся бояться боится 
дождь: дождя дождь 
грязь: грязи 
использовать: использую использовали использовать 
такой: такие таком такая такую 
режим: режиме режим 
радио: радио 
кухня: кухне 
выводить: выводит 
необходимость: необходимости необходимость 
отключать: отключить 
полагать: положить 
рюкзак: рюкзаку рюкзак рюкзаке 
последний: последних последние 
год: годы лет году года 
протестировать: протестировал 
множество: множество 
аудиосистема: аудиосистема аудиосистеме аудиосистем 
подборка: подборки подборке 
собирать: собрал 
пять: пять 
разный: разных разные разного 
задача: задача задач 
ценовый: ценовых 
категория: категории категорий 
бесплатный: бесплатный 
курс: курс 
взрослый: взрослым 
независимый: независимы независимым 
разбираться: разбираемся 
налог: налога налог налогах налоги 
право: правах 
искать: ищем 
жилье: жилье 
оплачивать: оплачиваем 
коммуналка: коммуналку 
изучать: изучить изучив изучаем изучили 
критерий: критериям критерии 
отбор: отбора 
составление: составлении 
опираться: опирался 
личный: личный 
опыт: опыт 
также: также 
отзыв: отзывы 
владелец: владельцу владелец владельцев 
обзор: обзоров обзоре обзор обзоры 
профильный: профильных 
издание: изданиях 
список: список 
входить: вошли 
доступный: доступные 
продажа: продаже 
иметь: имеет имеют 
баланс: баланс 
звучание: звучания звучание 
габарит: габариту габаритам габаритов 
подходить: подойдут подходит подходят 
выбирать: выбранные выбрал выбирать 
устройство: устройство устройств устройства 
совет: советы 
ниже: ниже 
подбирать: подобрать 
самостоятельно: самостоятельно 
вес: вес весу весом веса 
размер: размера размером размеры 
рынок: рынок рынке 
встречаться: встречаются 
формат: формата формате 
ультракомпактный: ультракомпактные 
который: который которые которых которой которого которую которыми которая которое 
помещаться: помещаются помещается 
карман: карман 
огромный: огромных огромные огромный огромная 
акустический: акустические 
система: систему системы 
кг: кг 
большой: большим больших большой большие 
количество: количества количеством количество количеству 
человек: людей человеку человек 
зависеть: зависит 
портативность: портативность 
планировать: планируете 
регулярно: регулярно 
носить: носить 
себя: собой 
желательно: желательно 
небольшой: небольшой небольших небольшие небольшая 
килограмм: килограмма килограмм 
умный: умные умным умной 
любой: любого любой любое любых 
бюджет: бюджета 
длина: длиной 
примерно: примерно 
см: см 
около: около 
полукилограмма: полукилограмма 
считать: считать 
оптимальный: оптимальным оптимальный 
вариант: вариантов вариантом 
часто: чаще часто 
довольно: довольно 
громкий: громким громкая громкой громкий 
слишком: слишком 
тяжелый: тяжелый тяжелые тяжелая 
возить: возить 
громкость: громкости громкость 
измеряться: измеряется 
суммарный: суммарной 
мощность: мощностью мощности мощность 
динамик: динамиков динамик 
ватт: ваттах 
условно: условно 
разделять: разделить разделяют 
вт: вт 
начальный: начальный 
уровень: уровне уровень 
немного: немного 
громко: громко громче 
ноутбук: ноутбука 
средний: средней средним средняя средними средних средние 
достаточно: достаточно 
квартира: квартиры квартиру 
пикник: пикника 
дачный: дачного 
участок: участка участок 
мощный: мощных мощные мощная мощный 
устраивать: устроить устраивает 
дискотека: дискотеку 
открытый: открытом 
воздух: воздухе 
тип: тип типов типа 
несколько: несколько нескольких 
вид: видов вид 
каждый: каждый каждым 
влиять: влияет 
определенный: определенным 
образ: образом 
один: одни одном одной одна одного одним 
прорабатывать: проработанный проработает проработанным 
четкий: четким 
широкополосный: широкополосных широкополосный 
общий: общего общей 
назначение: назначения 
широкий: широким 
диапазон: диапазона диапазоне диапазоном 
частота: частот частотами частоты 
именно: именно 
твитер: твитеры твитера твитер 
маленький: маленькая маленький маленькой 
предназначать: предназначенный 
высокий: высокие высокой высоких 
улучшать: улучшает 
четкость: четкость 
воспроизведение: воспроизведения 
вокал: вокала вокал 
некоторые: некоторые некоторых 
инструмент: инструменты инструментов 
вуфер: вуфер вуферов 
низкочастотный: низкочастотных низкочастотный 
усиливать: усиливает 
бас: басами басов басы бас баса 
делать: делать делает делал 
пассивный: пассивный пассивных 
излучатель: излучатель излучателя 
воспроизводить: воспроизводит 
это: это 
дополнительный: дополнительная дополнительные 
мембрана: мембрана 
объемный: объемного объемнее объемным объемное 
насыщенный: насыщеннее насыщенным насыщенного 
четко: четче 
музыка: музыкой музыка музыку музыки музыке 
моно: моно 
играть: играют играем играет играла играющей 
разделение: разделения 
левый: левый левую 
правый: правый правую 
сторона: сторону стороне 
чистый: чистым чистого чистый 
реалистичный: реалистичнее реалистичный реалистичным реалистично 
привычно: привычнее 
слышать: слышал слышать 
ухо: ухом 
то: тому 
больший: большая 
часть: часть 
записываться: записывается 
стерео: стерео 
моноколонка: моноколонки 
искусственно: искусственно 
канал: канал каналов канала 
одинаковый: одинаковых 
динамика: динамика динамики динамиках 
два: две двум двух 
группа: группы 
аудиопоток: аудиопоток 
соответствие: соответствии 
музыкант: музыканты 
стоять: стоят стоит 
сцена: сцене 
компактный: компактная компактных 
беспроводной: беспроводных беспроводной беспроводная 
размещать: разместить 
поэтому: поэтому 
стереомодель: стереомодели 
уступать: уступают 
монофонический: монофоническим монофоническое 
детализация: детализации 
автономность: автономность 
обычно: обычно 
характеристика: характеристиках 
указываться: указывается 
время: время 
проигрывание: проигрывания 
емкость: емкостью емкость 
аккумулятор: аккумулятора аккумулятор 
расход: расход 
энергия: энергии 
наличие: наличия наличии 
подсветка: подсветки подсветкой подсветка 
другой: другое других другие 
фактор: факторов 
сравнивать: сравнивал сравнивать 
объем: объему объема 
батарея: батареи 
защита: защиты защита защитой 
вода: воды воду водой 
пыль: пыль пыли 
нужно: нужно 
маркировка: маркировку 
ip: ip 
международный: международный 
стандарт: стандарт стандарту стандарты 
показывать: показали показывает 
степень: степени степень 
устойчивость: устойчивости 
гаджет: гаджета гаджеты 
внешний: внешних внешним 
воздействие: воздействиям 
становиться: стать 
президент: президентом 
америка: америки 
потренироваться: потренироваться 
неизбитый: неизбитых 
функция: функцию функции функция функций 
ipxx: ipxx 
xx: xx 
указывать: указаны указывает 
первый: первого первая 
цифра: цифра 
говорить: говорит 
проникновение: проникновения 
песок: песка песок 
второй: второй вторая 
влагозащищенность: влагозащищенности 
важно: важно 
влагозащита: влагозащита влагозащиты 
распространяться: распространяется 
пресный: пресную 
напиток: напитки 
падение: падения падение 
море: море 
равно: равно 
мочь: могут 
повреждать: повредить 
поверхностный: поверхностного 
попадание: попадания 
капля: капель капли 
надежный: надежная 
допускаться: допускается 
кратковременный: кратковременное 
погружение: погружение 
глубина: глубину 
метр: метров метра 
защищать: защищена защищенная защищен 
смочь: сможет 
переживать: пережить 
полтора: полтора полутора 
производитель: производители производителя 
добавлять: добавляют 
синхронизация: синхронизацию синхронизации 
сделать: сделать 
мощно: мощнее 
расставлять: расставить 
комната: комнатах комнату комнате 
пауэрбанк: пауэрбанка пауэрбанк 
подключение: подключения 
предусматривать: предусмотрен предусмотрены 
площадка: площадкой площадка 
зарядка: зарядки 
простой: попроще 
просто: просто проще 
гореть: горит 
мигать: мигает 
дорогой: дорогая дорогих дороже 
переливаться: переливается 
такт: такт 
привлекать: привлекает 
внимание: вниманием внимание 
нравиться: нравилась нравится 
пользователь: пользователям пользователи пользователей 
быстро: быстро быстрее 
расходовать: расходует 
заряд: заряде заряда заряд 
оснащать: оснащают оснащена 
встроенный: встроенного встроенный встроенным 
микрофон: микрофона микрофон микрофонов микрофоном 
гарнитур: гарнитуру 
бывать: бывает 
nfc: nfc 
быстрый: быстрого 
практика: практике 
полезно: полезно 
переплата: переплаты 
алиса: алисой 
пока: пока 
управление: управления 
дом: домом 
ассортимент: ассортимент 
магазин: магазинов 
покупатель: покупателей покупателя 
девять: девять 
соответствовать: соответствующих 
jbl: jbl 
flip: flip 
charge: charge 
clip: clip 
partybox: partybox 
bang: bang 
olufsen: olufsen 
beolit: beolit 
xiaomi: xiaomi 
mi: mi 
portable: portable 
bluetooth: bluetooth 
speaker: speaker 
marshall: marshall 
emberton: emberton 
lg: lg 
xboom: xboom 
go: go 
pl: pl 
anker: anker 
soundcore: soundcore 
mini: mini 
pro: pro 
номинация: номинации 
выбор: выбор 
бюджетный: бюджетная 
автономный: автономной автономная автономные 
мероприятие: мероприятий 
наш: наши нашем 
рекомендация: рекомендации 
яркий: ярче ярким яркую 
дизайнерский: дизайнерская 
отличный: отличным 
р: р 
недорогой: недорогая недорогих 
фоновый: фоновой 
город: городом города городе 
весить: весит 
dns: dns 
sony: sony 
очень: очень 
рейв: рейв 
уличный: уличный уличных 
концерт: концерт 
получать: получить получим получать получили 
комиссия: комиссию 
покупка: покупки покупкой покупку 
товар: товаров товары 
искажать: искажаем искажает 
приукрашивать: приукрашиваем 
конкретный: конкретных 
вещь: вещи вещей 
тинькофф: тинькофф 
журнал: журнала журнале 
выносить: выносим 
вердикт: вердикт 
основа: основе 
тщательно: тщательно 
редакционный: редакционных 
либо: либо 
запрашивать: запрашиваем 
закупать: закупаем 
сам: саму сами 
рецензия: рецензии 
мнение: мнению мнения мнение 
субъективный: субъективные 
честный: честные 
экспертный: экспертные 
писать: пишут 
плечо: плечами 
команда: команда 
редактор: редакторов 
перепроверять: перепроверяет 
текст: тексты 
вычитывать: вычитывает 
проводить: проводит 
фактчекинг: фактчекинг 
момент: момент 
выход: выхода 
материал: материала 
периодически: периодически 
обновлять: обновляем 
актуальный: актуальными актуальнее 
бутылка: бутылку бутылки 
г: г 
бассейн: бассейн 
хватить: хватит 
час: часов 
намного: намного 
сравнимый: сравнимого сравнима 
максимальный: максимальной максимальная 
хрипеть: хрипит 
песня: песен 
отлично: отлично 
прослушивание: прослушивании прослушивания 
практически: практически 
трек: треков треки 
характерный: характерный 
отодвигать: отодвигает 
план: план 
отдельный: отдельного отдельный 
выделять: выделенного выделяет 
вроде: вроде 
тарелка: тарелок 
скрипка: скрипок 
благодаря: благодаря 
что: чему 
весь: весь 
восприниматься: воспринимается 
учитывать: учитывать 
направленный: направленное 
сравнение: сравнении 
крупный: крупными 
хватать: хватает 
ставить: ставить 
стена: стене 
угол: угол 
все: всем всё 
слышно: слышно 
объединять: объединить 
единый: единую 
сразу: сразу 
называться: называется 
partyboost: partyboost 
активация: активации 
специальный: специальная 
кнопка: кнопка 
корпус: корпус корпусе 
синхронизировать: синхронизировать 
поддерживать: поддерживают 
большинство: большинство 
плохой: плохой 
будильник: будильник 
sberbox: sberbox 
time: time 
сколько: сколько 
альтернатива: альтернатива альтернативы 
хотеться: хочется 
похожий: похожа похожее похож 
дешево: дешевле 
c: c 
тихо: тише 
достигать: достигла достигает 
сбалансировать: сбалансированного сбалансированный 
ярко: ярко 
справляться: справляется 
водоустойчивость: водоустойчивости 
зато: зато 
держать: держит 
этот: этих эта 
мало: меньше 
высокочастотный: высокочастотного 
широкополосник: широкополосникам широкополосника 
возникать: возникали возникнет возникает 
эффект: эффект эффектом 
заполнять: заполнит заполняет 
направление: направлениях 
несовершенный: несовершенный 
живой: живым живой 
присутствие: присутствия 
ожидать: ожидаешь 
выглядеть: выглядит 
ощущаться: ощущается 
рука: руках 
прорезиненный: прорезиненного 
текстурный: текстурного 
пластика: пластика 
ощупь: ощупь 
экокожа: экокожу 
металлический: металлический 
джойстик: джойстик 
верхний: верхней 
панель: панели 
удобный: удобная удобный удобным 
смотреться: смотрится 
необычно: необычно 
ipx: ipx 
кто: кому 
мини: мини 
самый: самая самых 
одновременно: одновременно 
корзинка: корзинку 
винтажный: винтажный 
радиоприемник: радиоприемник 
вписываться: вписалась впишется 
интерьер: интерьер 
обращаться: обращаться 
осторожно: осторожно 
восемь: восьми 
углубление: углубление 
сверху: сверху 
целый: целый целых 
четыре: четырех четыре 
усиление: усиления 
низкий: низких низкой низком 
равномерный: равномерного 
распределение: распределения 
устанавливать: установлены 
запас: запас 
людный: людной 
лишенный: лишен 
неприятный: неприятных 
искажение: искажений 
удачно: удачно 
передавать: передает передают 
улавливать: уловить 
переход: переходы 
изменение: изменения 
голос: голосе 
смена: смену 
тембр: тембра 
выходить: выйти выходят 
контроль: контроля 
чувствоваться: чувствуются 
перенасыщать: перенасыщенными 
кожаный: кожаная 
ручка: ручка ручку 
далеко: далеко 
желание: желании 
стереопара: стереопару 
домашний: домашнюю 
разъем: разъем разъемов 
проводной: проводного 
плеер: плееру 
традиция: традициях 
аксессуар: аксессуаров 
свой: свои своему 
вполне: вполне 
неплохо: неплохо 
прикреплять: прикрепить 
велосипед: велосипеду 
вылазка: вылазки 
попадать: попасть попадали 
единственный: единственного 
неплохой: неплохая неплохого 
точно: точно 
современный: современного 
важный: важна 
например: например 
подкастовый: подкастов 
поход: походе 
шумоподавление: шумоподавлением 
связь: связи 
карабин: карабином 
работа: работе работы 
вдвое: вдвое 
раз: разу раза 
пульсирующий: пульсирующую 
разговор: разговоров 
удобно: удобно 
многолюдный: многолюдных 
ваш: вашу 
возможно: возможно 
доходить: дойдет 
сосед: соседей соседи 
подзарядка: подзарядки 
составлять: составляет составить 
громоздкий: громоздкие 
бумбокс: бумбоксы бумбокс 
помощь: помощью 
комфортно: комфортно 
слушать: слушать 
ритмичный: ритмичные 
низы: низы низов 
электроника: электронику 
рэп: рэп 
изобиловать: изобилует 
понравиться: понравиться 
любитель: любителям любителей 
рок: рока рок 
метать: метала 
прямо: прямо 
сердечко: сердечко 
проверять: проверенных 
останавливать: остановит 
сильный: сильный 
уметь: умеет 
подзаряжать: подзаряжать 
располагать: расположен 
полноценный: полноценный 
выездной: выездных 
лекция: лекций 
музыкальный: музыкальных 
выступление: выступлений 
сотня: сотню 
вертикально: вертикально 
горизонтально: горизонтально 
оба: обоих 
положение: положениях 
резиновый: резиновые 
ножка: ножки 
случай: случаи 
жизнь: жизни 
электрогитара: электрогитары 
вход: вход 
обычный: обычных 
usb: usb 
флешка: флешки 
телефон: телефона телефон 
караоке: караоке 
построить: построен 
шесть: шести 
пара: пару пары паре 
высокочастотников: высокочастотников 
тыльный: тыльной 
сочный: сочные 
глубокий: глубоким глубокие 
танцевальный: танцевальной танцевальные 
хит: хиты 
прокачивать: прокачать 
загородный: загородный 
выкручивать: выкручивать 
высоко: выше 
вместо: вместо 
саундбар: саундбара 
телевизор: телевизора телевизору 
поддерживаться: поддерживается 
сабвуфер: сабвуферы 
чувствительный: чувствительные чувствительной 
речь: речь 
грохот: грохот 
взрыв: взрывов 
выключать: выключенной 
спокойно: спокойно 
отправляться: отправляться 
глушь: глушь 
день: день 
лишь: лишь 
ощутимо: ощутимо 
обилие: обилием 
комплект: комплекте 
прилагаться: прилагается 
постить: постим 
кружочек: кружочки 
красивый: красивые красивая 
карточка: карточки 
новость: новости 
технология: технологиях 
подписываться: подписывайтесь 
классно: классно 
тэг: тэги 
техника: техника техники 
нужный: нужна 
комментарий: комментарии 
проходить: проходят 
модерация: модерацию 
правило: правилам правила 
alexander: alexander 
герой: герой 
главное: главное 
она: её 
наушник: наушников наушники 
общественный: общественных 
место: местах мест 
отвечать: ответить 
отредактировать: отредактировано 
невозможно: невозможно 
приезжать: приехать 
отдыхать: отдохнуть 
послушать: послушать 
находиться: нахожусь найдутся 
особо: особо 
личность: личности 
врубать: врубят 
округ: округу 
недостаточно: недостаточно 
машина: машину машине 
вокруг: вокруг 
еще: ещё 
назло: назло 
надолго: надолго 
изобретение: изобретение 
россиянин: россиян 
превращаться: превратиться 
оружие: оружие 
массовый: массового 
поражение: поражения 
проваливаться: провались 
никита: никита 
грунтович: грунтович 
дааа: дааа 
жалеть: жалею 
шум: шум 
автозвук: автозвука 
подводить: подвести 
ветер: ветер 
тишина: тишину 
готовый: готовы 
платить: платил платить 
алексей: алексей 
петров: петров 
недостаток: недостаток 
влезать: влезут 
задница: задницу 
травма: травм 
непременно: непременно 
рано: рано 
поздно: поздно 
публичный: публичных 
особенно: особенно 
вечерний: вечернее 
ночной: ночное 
иначе: иначе 
покупать: покупать покупаю 
кстати: кстати 
число: числом 
раздавать: раздавать 
некоторый: некоторому 
друг: друзей 
совместный: совместного 
улица: улице 
замена: замена 
понимать: поняли 
ольга: ольга 
степанова: степанова 
эх: эх 
жаль: жаль 
поиск: поиска 
ценовой: ценового ценовом 
тысяча: тысяч 
агент: агент 
лукошко: лукошко 
дешевый: дешевая 
серия: серии 
ola: ola 
perlina: perlina 
брать: беру 
групповой: групповые 
пробежка: пробежки 
огонь: огонь 
юрий: юрий 
колчин: колчин 
kilburn: kilburn 
ii: ii 
black: black 
шикарный: шикарный 
идеально: идеально 
статья: статья статьи 
классный: классные классная 
тестировать: тестировал 
назад: назад 
тяжело: тяжело 
находить: найти 
везде: везде 
блеск: блеск 
батя: бати 
давно: давно 
приготавливать: приготовлен 
котел: котел 
масло: маслом 
дмитрий: дмитрий 
капустин: капустин 
настольный: настольные настольный 
теннис: теннис 
парк: парке 
кататься: катаемся кататься 
пустынный: пустынном 
каток: катке 
любимый: любимую 
супер: супер 
ездить: ездим 
лыжа: лыжах 
велик: велике 
карманный: карманную 
железный: железным 
цепляться: цепляется 
блутус: блутусу 
невзгода: невзгод 
емкий: емкий 
мороз: морозе 
включать: включаю включал 
навязывать: навязываю 
окно: окна 
сергей: сергей 
неделя: недели неделю 
сегодня: сегодня 
переставать: переставала перестала 
включаться: включаться 
ронять: ронял 
мощь: мощь 
турция: турции 
представитель: представитель 
компания: компании 
сказать: сказал 
везти: вези 
россия: россию 
сервисный: сервисный 
центр: центр 
отношение: отношение 
клиент: клиентам 
пользоваться: пользуюсь 
прекрасный: прекрасный 
девайс: девайс 
любить: люблю 
звучать: звучит 
офигенный: офигенно 
просмотр: просмотре 
фильм: фильмов 
цеплять: цеплял 
мобильный: мобильная 
спасать: спасает 
сессия: сессиях 
игра: игры 
решать: решил 
богато: богаче 
кажется: кажется 
идти: идет 
упор: упор 
жирненький: жирненького 
начало: начале 
отдавать: отдал 
vladimir: vladimir 
bezrukavyi: bezrukavyi 
sonos: sonos 
roam: roam 
move: move 
bmo: bmo 
хотеть: хотел хочет 
сонос: соносы 
достойный: достойная достойно достойные достойных 
обделять: обделили 
популярный: популярен популярны популярное 
bose: bose 
разрекламировать: разрекламирован 
наверно: наверно 
валерий: валерий 
завалишин: завалишин 
владение: владении 
штука: штуки 
doss: doss 
soundbox: soundbox 
дача: даче 
ноут: ноута 
ego: ego 
влагозащищенный: влагозащищенная 
выезд: выездов 
гость: гости 
boris: boris 
остальное: остальное 
motion: motion 
plus: plus 
roman: roman 
вообще: вообще 
недорейтинг: недорейтинг 
адекватный: адекватные 
конкурент: конкуренты 
sven: sven 
tronsmart: tronsmart 
получаться: получилось 
упоминать: упомянуть 
обращать: обратить 
aliexpress: aliexpress 
российский: российском 
ритейл: ритейле 
бренд: бренда 
широко: широко 
представлять: представлен представлены 
частенько: частенько 
ко: ко 
компромисс: компромиссы 
слабый: слабая 
отсутствие: отсутствие 
вопрос: вопросы 
ситуация: ситуация 
сильно: сильно 
плавать: плавает 
владимир: владимир 
савичев: савичев 
нигде: нигде 
урал: урала 
андрей: андрей 
пляж: пляжа 
бенг: бенг 
олуфсен: олуфсен 
натяжка: натяжкой 
называть: назвать 
плохо: плохо 
шнур: шнур 
марина: марина 
русский: русская 
xtreme: xtreme 
ермолов: ермолов 
pulse: pulse 
принцип: принципе 
aleksandr: aleksandr 
k: k 
приобретать: приобрел 
аккумуляторный: аккумуляторного 
магнетрон: магнетрона 
направлять: направленного 
действие: действия 
незаметно: незаметно 
сжигать: сжигал 
действовать: действовать 
нерв: нервы 
окружать: окружающим 
ванеев: ванеев 
tribit: tribit 
stormbox: stormbox 
blast: blast 
boombox: boombox 
обзорщик: обзорщиков 
целое: целом 
топ: топ 
качественный: качественного 
thunderbox: thunderbox 
gen: gen 
малый: малых 
micro: micro 
присматриваться: присмотритесь 
рабочий: рабочий 
эквалайзер: эквалайзер 
запад: западе 
мы: нам 
приходить: приходят 
гэнгбэнг: гэнгбэнгом 
олуфсено: олуфсеном 
jblом: jblом 
мир: мир 
катер: катер 
соотношение: соотношению 
анкер: анкер 
моушн: моушн 
плюс: плюс 
протяжение: протяжении 
вадим: вадим 
недавно: недавно 
дарить: дарил 
др: др 
audio: audio 
addon: addon 
приятно: приятно 
влудь: влудя 
странно: странно 
huawei: huawei 
sound: sound 
joy: joy 
мошенник: мошенникам 
понадобиться: понадобились 
справка: справки 
репетитор: репетитор 
полагаться: полагался 
каникулы: каникулы 
инвалидность: инвалидностью 
копить: копить 
балл: баллы 
уведомлять: уведомлять 
счет: счет счетах 
белоруссия: белоруссии 
работник: работник 
поставлять: поставлять поставить 
работодатель: работодателю 
ипать: ип 
молодой: молодой 
оформлять: оформить 
риск: риски 
быть: будут 
сотрудничать: сотрудничают 
иностранный: иностранным 
заливать: залили 
дверной: дверную 
замок: замок 
клей: клеем 
протест: протест 
ремонт: ремонта 
завещание: завещание 
ребенок: дети детей 
муж: мужа 
имущество: имущество 
стоимость: стоимости 
здание: здание 
рассказывать: расскажите 
проблема: проблемы проблеме 
багаж: багажом 
поездка: поездках 
косметичка: косметичка 
уход: уход 
комбинированный: комбинированной 
кожа: кожей 
акна: акне 
последствие: последствия 
продавец: продавец 
вносить: внесет 
доля: доли 
вернуть: вернуть 
обучение: обучение 
отрабатывать: отработала 
срок: срок 
целевой: целевому 
договор: договор договору 
процент: проценты 
посылка: посылка 
застревать: застряла 
таможня: таможне 
стаут: стауты 
гоза: гозе 
ламбик: ламбики 
пить: пить 
крафтовый: крафтовое 
пиво: пиво 
москва: москве 
жить: живет 
бали: бали 
зарплата: зарплатой 
въезд: въезда 
сербия: сербию 
поколение: поколение 
девяностый: девяностых 
лишний: лишнее 
труд: труда 
директор: директор 
розничный: розничной 
сеть: сети 
поволжье: поволжье 
экономист: экономист 
дежурный: дежурный 
электромонтер: электромонтер 
новосибирск: новосибирске 
тратить: тратила 
впечатление: впечатления 
apple: apple 
watch: watch 
вакансия: вакансии 
сообщать: сообщить 
проект: проекте 
контакт: контакты 
политика: политика 
конфиденциальность: конфиденциальности 
пользование: пользования 
сайт: сайтом 
ао: ао 
банк: банк 
лицензия: лицензия 
