экономика: экономике экономику экономики экономика 
финансы: финансы 
мир: мир миру мире мира мирами 
гарри: гарри 
поттер: поттеров поттером поттере поттер поттеру поттеры поттера 
промой: промо 
увеличивать: увеличивать увеличьте увеличить 
доход: доход 
сообщество: сообществом сообщество 
инвестор: инвесторов 
это: этим этому это 
работать: работает работают работал работающие 
учебник: учебник учебники 
сравнятор: сравнятор 
ипотека: ипотека 
кредитный: кредитная 
история: история 
тест: тесты 
дневник: дневники дневник 
трата: трат 
налоговый: налоговые налоговую налоговый 
вычет: вычет 
написать: напишите написать написано 
инвестиция: инвестиции инвестициях 
бизнес: бизнес бизнесе бизнеса 
разбор: разбор разборы 
закон: законов закона 
калькулятор: калькулятор калькуляторы 
путешествие: путешествий путешествие путешествия 
медицина: медицина 
здоровье: здоровье 
недвижимость: недвижимость недвижимости 
подкаста: подкасты 
видео: видео 
смотреть: смотреть 
сервис: сервисы 
расчет: расчеты 
закладка: закладки 
письмо: письма письмо 
оставаться: оставайтесь 
деньги: деньгами деньги денег 
поток: потоки 
устраивать: устроены 
гоблинский: гоблинское гоблинской 
золото: золото золота золотом 
важный: важнейшая важнейший важная важной 
роль: роль 
госсектор: госсектора 
немножко: немножко 
рабский: рабского рабский 
труд: труда труд 
волшебник: волшебников волшебники волшебник волшебника волшебнику волшебниками волшебником 
создавать: созданный создавать создать 
джоан: джоан 
роулинг: роулинг 
один: одни одному одном одна одного одно 
самый: самыми самую самое самом самый самой самых 
популярный: популярное популярными популярных 
решать: решил решает решили 
разбирать: разбирает разобрать 
магический: магической магические магическое магическая магических магического магическим 
британия: британии британия 
финансовый: финансового финансовую финансовой финансовая 
система: система систему системы 
рассказывать: расскажу рассказано расскажите 
влияние: влияние 
магия: магии магию магия магией 
гринготтс: гринготтс гринготтсе гринготтса 
социальный: социального социальное 
расслоение: расслоение 
евгений: евгений 
шепелев: шепелев 
получать: получаемые получить получать получили получает получил 
хогвартс: хогвартсе хогвартс хогвартса 
профиль: профиль 
автор: автора автор 
книга: книги книге книгам книгах 
фильм: фильмы фильмах фильм фильме фильмам фильмов 
рассказываться: рассказывается 
подробно: подробно 
общество: обществе общество 
целое: целом 
сторона: стороны 
довольно: довольно 
отдельный: отдельных 
данный: данных 
позволять: позволяют позволяет позволить 
составлять: составить составляют составлять 
общий: общее общих 
представление: представление 
судя: судя 
все: всем всё всему 
британский: британские британских 
капитализм: капитализм 
рыночный: рыночная 
нюанс: нюансами 
компания: компании компаний компания 
принадлежать: принадлежащих принадлежит принадлежат 
частный: частные частная частным частный 
лицо: лицам лице лица 
государственный: государственный государственных 
мало: мало меньше 
крайний: крайней 
мера: мере 
прямо: прямо 
упоминаться: упоминаются упоминается 
государство: государство 
министерство: министерства министерство министерстве министерством министерству 
особо: особо 
вмешиваться: вмешивается 
зато: зато 
покрывать: покрывает 
расход: расходы 
обучение: обучение обучения обучении 
студент: студентов 
одновременно: одновременно 
наверняка: наверняка 
крупный: крупных крупный крупнейший крупная 
работодатель: работодатель работодателей работодателю 
сильно: сильно 
влиять: влияет влиять 
производство: производство 
логистика: логистику 
сфера: сферу 
услуга: услуг услуги 
потребительский: потребительские потребительских 
привычка: привычки 
чара: чары 
хотя: хотя 
временно: временно 
превращать: превращать 
предмет: предметы предметов 
другой: другие других 
копировать: копировать 
ремонт: ремонта 
многие: многие 
помогать: помогает помогающие помогают 
быт: быту 
всесильный: всесильна 
например: например 
призывать: призвать 
ехать: едут еду 
количество: количество 
иметься: имеющейся имеющихся имеющееся 
просто: просто проще 
еда: еда 
принципиальный: принципиальных 
исключение: исключений 
трансфигурация: трансфигурации 
гэмп: гэмпа 
разный: разные разными разных 
способ: способов способы способ 
перемещение: перемещения 
ускорять: ускоряют 
упрощать: упрощают 
некоторые: некоторые 
перемещаться: перемещаться 
мгновенно: мгновенно 
бесплатно: бесплатно 
левитация: левитация 
уменьшение: уменьшения 
вес: веса 
место: место места местами мест 
использоваться: используется 
бесплатный: бесплатный бесплатное 
домовый: домовых 
эльф: эльфов эльфы 
суть: сути 
прибирать: прибирают 
дома: дома 
готовить: готовит готовят 
пища: пищу 
далее: далее 
правда: правда 
далеко: далеко 
богатый: богатые богатых богатым 
семья: семьи семьей семьям семей семья семье 
тип: типа 
малфой: малфоев 
блэк: блэков 
также: также 
деловой: деловой 
центр: центре центром центр 
косой: косой косом косым 
переулок: переулке переулок переулком 
скрытый: скрытая 
улица: улица 
лондон: лондона лондоне 
находиться: находятся находится 
основной: основные основную основная 
магазин: магазинов магазин магазинами магазины магазина 
банк: банк банков банке 
редакция: редакция 
газета: газета газеты газете 
пророк: пророк 
главный: главного 
сми: сми 
выходить: выйти выходит 
ежедневно: ежедневно 
общественный: общественный общественное 
мнение: мнения мнение 
второй: второй второе 
значимость: значимости 
деревня: деревня 
хогсмид: хогсмиде хогсмид 
около: около 
школа: школа школы школу школах школ 
чародейство: чародейства 
волшебство: волшебства 
паб: пабы паб 
серый: серая серой 
черный: черной черная 
который: который которой которых которые которого которыми которая которым которому 
называть: назвал 
лютный: лютным лютном лютный 
располагать: расположены расположенный 
рядом: рядом 
он: нему 
вернуться: вернуться вернусь 
делать: делать делает делают 
хороший: хорошую лучшие лучшее 
неделя: неделю 
ваш: вашей 
почта: почта почте почты 
каждый: каждый 
понедельник: понедельник 
подписываться: подписаться подписывайтесь 
важно: важно 
помнить: помнить 
маг: маги магов магам 
небольшой: небольшая небольшого небольшой небольшое 
говориться: говорится 
сколько: сколько 
жить: живут живет жить 
великобритания: великобритании великобританию 
попробовать: попробую 
оценивать: оценить 
примерный: примерное 
число: число числу 
учиться: учатся училось 
ребенок: детям дети детей 
год: год годов году лет года 
считать: считает считают считать считая 
совокупность: совокупность 
ученик: учеников 
практически: практически 
население: населения население населению населении 
возраст: возрасте возраста 
вряд: вряд 
домашний: домашнем 
иностранный: иностранных иностранным 
курс: курса курсу курсе курс 
человек: людей человеку человек 
именно: именно 
столько: столько 
имя: имен 
изначально: изначально 
придумывать: придумать придумала 
однокурсник: однокурсников 
итог: итоге 
попадать: попало 
список: список 
изначальный: изначальных 
предполагать: предположу предположить предположил 
шесть: шести 
курсы: курсах 
принимать: примем принимают 
минимально: минимально 
возможный: возможны возможную возможен возможное 
узник: узник 
азкабан: азкабана 
сказать: сказал сказать сказала сказано 
время: время временем 
матч: матча 
квиддич: квиддич квиддичу 
факультет: факультетов факультеты факультет 
слизерин: слизерин 
болеть: болел болело 
недолюбливать: недолюбливают 
слизеринцев: слизеринцев 
маловероятный: маловероятно 
получаться: получается 
интервью: интервью 
упоминать: упомянула упомянуть упомянул упомянутая упомянуты упоминают 
тысяча: тысяч тысячи 
максимально: максимально 
величина: величину 
выяснять: выяснил 
середина: середине 
примерно: примерно 
млн: млн 
данные: данные 
возрастной: возрастная 
структура: структура структуру 
совпадать: совпадает 
маггловский: маггловские маггловской маггловском маггловский маггловских 
включая: включая 
скоро: скоро скорее 
часть: частью часть части 
родитель: родители родителей родителя 
городок: городок 
заметный: заметный заметное 
очень: очень 
мочь: могут мог 
купить: купленный купивший купить купил купленного 
метла: метлы 
целый: целой 
команда: команды 
особняк: особняке 
лестрейнджа: лестрейнджей 
относить: отнес отнести 
минимум: минимум 
обеспеченный: обеспеченным 
первый: первой 
хранилище: хранилищами хранилище хранилища 
множество: множество множеством 
золотой: золотых золотой золотые золотого золотая золотому 
монета: монеты монет монета 
доспехи: доспехов 
серебряный: серебряного серебряных серебряный серебряной 
кубок: кубок кубков 
ценный: ценных ценная 
вещь: вещи вещей 
зачарованный: зачарованный зачарованные 
дом: дом 
площадь: площадь площади 
гриммо: гриммо 
рассуждение: рассуждения 
больница: больницей больницу больница больнице больницы 
святой: святого 
мунго: мунго 
вполне: вполне 
обеспечивать: обеспеченная 
годрикова: годриковой 
впадина: впадине 
внушительный: внушительная 
горка: горка 
тема: теме тему 
волшебный: волшебные волшебная волшебных волшебную волшебном волшебное волшебный волшебного волшебной 
мама: мама 
папа: папа 
оставлять: оставили 
кадр: кадрам кадр 
помещаться: поместились 
слева: слева 
снизу: снизу 
сотня: сотен сотни 
фунт: фунту фунтам фунтов фунты фунта 
стерлинг: стерлингов 
источник: источник 
философский: философский 
камень: камень 
warner: warner 
bros: bros 
studio: studio 
бедный: бедных бедные 
римус: римуса 
люпин: люпина 
сложно: сложно 
находить: нашла найти 
работа: работу работы работой 
среди: среди 
поскольку: поскольку 
оборотень: оборотней оборотень 
бояться: боятся 
вообще: вообще 
зарабатывать: зарабатывает заработать зарабатывать 
маггл: магглов маггл 
факт: факт 
статут: статут 
секретность: секретности 
многодетный: многодетной многодетные многодетным 
уизли: уизли 
лежать: лежит 
одинокий: одинокая 
кучка: кучка 
голодать: голодают 
одежда: одежды одежду одеждой 
новый: новые новую 
палочка: палочку палочек палочки 
оцениваться: оценивается оцениваются 
неравенство: неравенство 
возможно: возможно 
такой: такого такая таким такому такое таких такую 
ситуация: ситуация 
связанный: связано связана связаны 
артур: артура артур 
свой: своей своими свои свой своего своих 
должность: должности 
жена: женой жена 
молль: молли 
домохозяйка: домохозяйка домохозяйку 
старший: старших старшие 
большой: большие 
несколько: несколько 
несовершеннолетний: несовершеннолетних 
шутка: шутка 
ведущий: ведущий 
научный: научный 
сотрудник: сотрудники сотрудник сотрудников 
институт: института 
анализ: анализа 
прогнозирование: прогнозирования 
ранхигс: ранхигс 
елена: елена 
гришина: гришина 
фактор: факторов 
возникновение: возникновения 
бедность: бедности 
рождение: рождением 
малыш: малыша 
потребность: потребности 
возрастать: возрастают 
видимо: видимо 
тяжело: тяжело 
учет: учетом 
значительный: значительную значительная 
питаться: питаются 
вероятно: вероятно 
помощь: помощи помощь помощью 
недостаточно: недостаточно 
дело: деле дело 
низкий: низкая низкой 
грамотность: грамотности 
выигрывать: выиграли 
лотерея: лотерею 
галлеонов: галлеонов 
немаленький: немаленькая 
сумма: сумма суммы 
мерка: меркам 
потратить: потратили 
египет: египет 
разумно: разумнее 
откладывать: отложить 
подушка: подушка подушку 
нужный: нужны нужна 
хранить: хранит хранить 
преступник: преступники 
описание: описанию 
неприятный: неприятное 
опасный: опасное опасном 
отмечать: отмечу 
происхождение: происхождение 
перспектива: перспективы 
жизнь: жизнь жизни 
отпрыск: отпрыскам 
чистокровный: чистокровных 
бывать: бывает 
сделать: сделайте сделать сделал сделанные 
карьера: карьеру 
кто: кого 
оба: оба 
сектор: секторе секторов сектора секторам сектор сектору 
хагрид: хагрид 
задача: задача задачи 
скрывать: скрыть скрывать 
весь: всей 
страна: стран стране 
волшебница: волшебницы 
функция: функции функций 
оно: оно 
поддерживать: поддерживает поддерживать 
порядок: порядка порядок 
бороться: борются борется 
преступность: преступностью 
темный: темными 
ликвидировать: ликвидирует 
последствие: последствия 
происшествие: происшествий 
следить: следит 
транспорт: транспорта транспорт 
контролировать: контролирует 
существо: существ 
образование: образованием образования 
вид: видами 
спорт: спорта 
игра: игр игры 
соответствующий: соответствующие 
отдел: отдела отделы отдел 
тайна: тайн 
изучать: изучает 
международный: международного международная 
сотрудничество: сотрудничества 
мракоборец: мракоборцам 
стиратель: стирателям 
память: памяти 
качественный: качественной 
нужно: нужно 
десяток: десятков 
занимать: занята займут 
трудоспособный: трудоспособного 
точно: точно 
известно: известно 
откуда: откуда 
берет: берет 
деятельность: деятельность деятельности 
платить: платил платят 
налог: налог налоги 
штраф: штрафы 
нарушение: нарушение нарушениям 
оштрафовать: оштрафовали 
заколдовывать: заколдовал 
автомобиль: автомобиль 
орган: орган 
власть: власти 
визенгамот: визенгамота визенгамот 
появляться: появился 
средний: среднее 
суд: судом 
парламент: парламентом 
член: членов 
статья: статьи статье статья 
орден: ордене орден 
мерлин: мерлина 
неизвестный: неизвестных 
показывать: показан показанных показывает 
считаться: считается 
последний: последних последнем последние 
главное: главное 
публичный: публичному 
атриум: атриум 
толпа: толпами 
посетитель: посетители посетителей 
феникс: феникса 
заниматься: занимаются занимающихся занимается 
сразу: сразу 
нефтегазовый: нефтегазового 
энергетик: энергетики 
коммунальный: коммунальных 
жкх: жкх 
домовой: домовые 
строить: строить 
неволшебник: неволшебникам 
посторонний: посторонние посторонних 
диверсифицировать: диверсифицировать 
портфель: портфель 
представитель: представителе 
отдельно: отдельно 
здравоохранение: здравоохранение здравоохранению 
представлять: представлена представляли представлены представлено 
лечить: лечат 
пострадавший: пострадавших 
проклятие: проклятий 
яд: ядов 
опасность: опасностей 
обычно: обычно 
больничный: больничном 
крыло: крыле 
платный: платное 
лечение: лечения лечение 
случай: случаем случае 
экстренный: экстренной 
неизвестно: неизвестно 
некоммерческий: некоммерческая 
организация: организация организациям 
правильно: правильнее 
бюджет: бюджета 
пожертвование: пожертвования пожертвование 
огонь: огня 
министр: министр 
корнелиус: корнелиус 
фадж: фадж 
люциус: люциус 
малфа: малфой 
щедрый: щедрое 
кидать: кидают 
фонтан: фонтан 
братство: братства 
аптека: аптек аптеки 
продавать: продающие продать продавать продаваемых 
зелье: зелий зелья 
варить: варить 
разрабатывать: разрабатывать 
фармацевтический: фармацевтические 
известный: известный известны 
малпеппер: малпеппера 
slug: slug 
jigger: jigger 
кроме: кроме 
ингредиент: ингредиенты 
оборудование: оборудование оборудования 
варка: варки 
включать: включают 
товар: товаров товарами товары 
необходимость: необходимости 
анализировать: анализировать 
привычный: привычным 
мы: нам 
схема: схемам 
скажем: скажем 
продукт: продуктами 
питание: питания 
кондитерская: кондитерская 
шугарплам: шугарплама 
королевство: королевство 
пусть: пусть 
покупка: покупка покупку 
многий: многих 
происходить: происходящего происходит 
инструмент: инструмент 
любой: любого 
олливандер: олливандер олливандера олливандером 
видный: видна виден 
вывеска: вывеска 
джимми: джимми 
кидделла: кидделла 
мадам: мадам 
малкин: малкин 
gladrags: gladrags 
wizardwear: wizardwear 
категория: категории 
относиться: относиться относится относятся 
книжный: книжный 
блоттс: блоттс 
умник: умников 
кафе: кафе 
флориана: флориана 
фортескью: фортескью 
котел: котел котлы котлов 
розыгрыш: розыгрышей 
зонко: зонко 
производить: производящие 
промышленный: промышленный 
производитель: производители 
зельеварение: зельеварения 
продукция: продукция 
личный: личного личные 
пользование: пользования 
тот: тех той ту 
формально: формально 
входить: входят входит 
поезд: поезд 
сопутствующий: сопутствующей 
инфраструктура: инфраструктурой 
каминный: каминная 
сеть: сети сеть 
летучий: летучего 
порох: пороха 
автобус: автобус 
рыцарь: рыцарь 
тесно: тесно 
плата: плату платы 
использование: использованием использования использование 
исчезательный: исчезательные 
шкаф: шкафы 
портал: порталов порталы 
трансгрессия: трансгрессии 
пространство: пространстве 
редко: редко 
встречаться: встречаются 
лишь: лишь 
экземпляр: экземпляра 
учить: учат 
шестой: шестом 
стоять: стоят стоит 
рискованный: рискованный 
серьезный: серьезные 
травма: травмы 
ошибаться: ошибиться 
сырьевой: сырьевой 
описывать: описан описаны 
выращивать: выращивающие 
растение: растения 
разводить: разводящие 
охотиться: охотящиеся 
артефакт: артефакты артефактами артефактов 
ритуал: ритуалов 
древесина: древесина 
дракон: драконов 
гоблин: гоблином гоблинов гоблины 
брать: берут 
серебро: серебро серебра серебру 
бронза: бронзу 
металл: металлы 
чеканить: чеканить чеканят 
оружие: оружие 
ювелирный: ювелирные 
изделие: изделия 
добывать: добывают 
выплавлять: выплавляют 
сам: сама сами 
покупать: покупает покупаем покупать покупают 
коммуникационный: коммуникационный 
совиный: совиная совиной 
зачастую: зачастую 
сова: совы 
причина: причина причинам причинах 
использовать: использовали использовать 
доставлять: доставлять 
посылка: посылки посылка 
путешествовать: путешествовать 
разговаривать: разговаривать 
конкурент: конкурентом 
заклинание: заклинание 
патронус: патронуса 
передавать: передавать 
сообщение: сообщения 
замена: заменой 
переходить: перейду 
менее: менее 
очевидный: очевидным 
экономический: экономическую экономическим 
вопрос: вопросу вопросы вопрос вопросам 
торговать: торгуют 
оборот: оборот 
ограничивать: ограничен 
запрещать: запрещен запрещает 
темномагический: темномагические 
сомнительный: сомнительные 
скупка: скупка 
краденый: краденого 
бэркс: бэркс 
заказывать: заказать 
незаконный: незаконным незаконные 
торговля: торговля 
определенно: определенно 
эпизодически: эпизодически 
некий: некий некая 
али: али 
башир: башир 
хотеть: хочет 
поставлять: поставлять поставить 
ниша: нишу 
семейный: семейного 
ковер: ковры 
импортировать: импортированные импортируют 
рубеж: рубежа 
иметь: имеет имеют 
тонкий: тонкие 
стенка: стенки стенок 
повышать: повышает 
риск: риск риски 
протечка: протечек 
перси: перси 
доклад: доклад 
стандартизировать: стандартизировать 
толщина: толщину 
близнец: близнецы близнецам 
порошок: порошок 
мгновенный: мгновенной 
тьма: тьмы 
перо: перу 
импорт: импорт 
должный: должен должны 
экспортировать: экспортирует 
задний: заднем 
план: плане 
вход: вход 
жительство: жительства 
склонный: склонных 
заглядывать: заглядывать 
тайный: тайная 
комната: комната комнат 
денежный: денежная 
единственный: единственный 
управлять: управляют 
штат: штата 
билл: билл 
ликвидатор: ликвидатор 
заклятие: заклятий 
здание: здание 
банка: банка 
обширный: обширные 
подземелье: подземелья подземельях 
ценность: ценности ценностей 
пожалуй: пожалуй 
эмиссия: эмиссия 
начинать: начну 
затем: затем 
направление: направления 
выпуск: выпуск 
выпускать: выпускать выпускает 
пользоваться: пользуются 
основа: основа 
согласовывать: согласует 
наименее: наименее 
бронзовый: бронзовый 
кнат: кнат кнатов 
образовывать: образуют 
сикль: сикль сикля 
сикля: сиклей 
равный: равны равен 
галлеон: галлеоны галлеону галлеона галлеон галлеоне 
видеть: видите 
логично: логично 
назад: назад 
отвечать: отвечала ответить 
фанат: фанатов фанатам 
колебаться: колеблется 
колебание: колебаний 
цена: цен ценами цена 
торговый: торговым 
баланс: баланс балансом 
исходить: исходить 
инфляция: инфляции инфляция 
эквивалентный: эквивалентно 
р: р 
цб: цб 
конец: конец 
январь: января 
взгляд: взгляд 
изготавливаться: изготавливается 
вручную: вручную 
служить: служит 
сайт: сайте сайтом 
bank: bank 
england: england 
частично: частично 
субсидировать: субсидирует 
впервые: впервые 
верить: верил 
смочь: сможет смогла 
отдавать: отдать 
себестоимость: себестоимости 
убыток: убыток 
договоренность: договоренность 
дамблдором: дамблдором 
насчет: насчет 
набор: набор 
сладость: сладостей 
наименование: наименований 
обходиться: обошелся 
современный: современных современную 
дорого: дорого 
рон: рон 
хватить: хватило 
двое: двоим 
голодный: голодным 
перекусить: перекусить 
приз: приз 
победа: победу 
турнир: турнира турнир турнире 
три: трех 
достаточно: достаточно 
захотеть: захотели 
участвовать: участвовать 
смертельно: смертельно 
соревнование: соревновании 
комплект: комплекте 
идти: идет 
слава: слава 
выражаться: выразилась 
француженка: француженка 
флер: флер 
делакур: делакур 
участница: участниц 
призовой: призовых 
шанс: шанс 
умирать: умерли 
кстати: кстати 
франция: франции 
образец: образца 
проходить: проходят проходил 
данна: данной 
открывать: открыть 
адекватный: адекватный 
район: районе 
иначе: иначе 
дешево: дешево 
пересчет: пересчете 
обмен: обменом обмен 
обратно: обратно 
кажется: кажется 
странный: странным 
одинаковый: одинаковое одинаковой 
масса: массы 
проба: пробу пробы 
равняться: равняться 
больший: большему 
подробный: подробный 
свойство: свойств 
hp: hp 
lexicon: lexicon 
соотношение: соотношением соотношения соотношение 
опускаться: опускалось 
ниже: ниже 
стоить: стоило 
дорогой: дороже 
тяжелый: тяжелый 
выглядеть: выглядящий выглядит выглядят 
солидно: солидно 
невысокий: невысокую 
вариант: вариант 
логичный: логичным 
чистый: чистого 
слишком: слишком 
мягкий: мягкой 
легко: легко 
повреждаться: повреждалась 
предположение: предположение 
драгоценный: драгоценные 
возникать: возникали возникают возникает 
возможность: возможности 
арбитраж: арбитража арбитраж 
менять: меняем 
выгодный: выгодному 
приходиться: придется 
уплачивать: уплатить 
комиссия: комиссию комиссиях 
гринготтсу: гринготтсу 
повторять: повторить повторяем 
profit: profit 
идея: идея 
фанфик: фанфике 
элиезер: элиезера 
юдковский: юдковский юдковского 
метод: методы 
рациональный: рационального 
мышление: мышления 
пообщаться: пообщавшись 
крюкохват: крюкохватом 
обменять: обменять 
тонна: тонну 
заплатить: заплатив 
чеканка: чеканки чеканку 
подумать: подумал 
биржевой: биржевой 
игрок: игрок 
захватить: захватить 
практика: практике 
мешать: мешать 
позиция: позиция 
операция: операций операции операциях 
заодно: заодно 
меняться: меняется 
bullionbypost: bullionbypost 
клиент: клиентов 
надежный: надежное 
пара: пару 
проникать: проникали 
вместо: вместо 
обычный: обычных 
маленький: маленьких 
ячейка: ячейка ячеек ячейки 
вплоть: вплоть 
полноценный: полноценных 
причем: причем 
глубокий: глубоких 
защита: защитой 
прежде: прежде 
банковский: банковский банковская 
весьма: весьма 
выдавать: выдает 
кредит: кредиты 
предоставлять: предоставлять 
управление: управления 
капитал: капиталом 
искусный: искусные 
кузнец: кузнецы 
ювелир: ювелиры 
меч: меч 
годрик: годрика 
гриффиндор: гриффиндора 
заказ: заказ 
недешево: недешево 
интересно: интересно 
аренда: аренду 
смерть: смерти 
покупатель: покупателя 
создатель: создателям 
истинный: истинным 
владелец: владельцам 
передача: передача 
наследство: наследству 
точка: точки 
зрение: зрения 
похожий: похожа 
кража: кражу 
знать: знаем 
какой: какую какие 
процентный: процентные 
ставка: ставки 
инвестировать: инвестировать 
сырье: сырье 
готовый: готовые 
странно: странно 
деталь: детали деталей 
убедительно: убедительно 
сей: сих 
пора: пор 
интересоваться: интересуются 
миллион: миллионы 
недостающий: недостающие 
додумывать: додумать 
самостоятельно: самостоятельно 
вкус: вкус 
фанатский: фанатских 
произведение: произведениях 
вселенная: вселенной 
писать: писали 
замок: замки замок 
собор: соборы 
виадук: виадук 
реальный: реальных реальная 
снимать: снимали 
убирать: убрали 
российский: российских 
hogwarts: hogwarts 
legacy: legacy 
россия: россии 
пк: пк 
xbox: xbox 
playstation: playstation 
switch: switch 
версия: версию 
выбирать: выбрать 
новость: новости 
касаться: касаются 
наш: нашем 
тэг: тэги 
кино: кино 
фотография: фотография 
обложка: обложке 
комментарий: комментарии 
модерация: модерацию 
правило: правилам правила 
журнал: журнала журналы 
карина: карина 
мальцев: мальцева 
герой: герой 
глядеть: глядишь 
узнавать: узнаем 
развиваться: развивалось 
сельский: сельское 
хозяйство: хозяйство 
ривенделл: ривенделле 
центнер: центнеров 
гектар: гектара 
намолот: намолот 
озимые: озимых 
прокармливать: прокормить 
поселение: поселение 
нолдоров: нолдоров 
восток: востоку 
море: моря 
ivan: ivan 
petrov: petrov 
совершенно: совершенно 
очевидно: очевидно 
гном: гномов 
сериал: сериале 
властелин: властелин 
кольцо: колец 
круто: круто 
пожалуйста: пожалуйста 
метро: метро 
котя: котя 
ряд: ряд 
журналистика: журналистикой 
радио: радио 
пример: примеру 
придерживаться: придерживается 
понимать: понимаю понимал 
куча: куча 
издание: издания 
досуг: досуг 
сегодня: сегодня 
спортивный: спортивные 
булат: булат 
понятно: понятно 
нуждающийся: нуждающимся 
размер: размерах 
влезать: влезет 
холодильник: холодильник 
имущество: имуществом имущество 
еще: ещё 
построить: построить 
простой: простого 
сшивать: сшить 
мантия: мантию 
почему: почему 
покоситься: покосившемся 
домик: домике 
хватать: хватает 
ходить: ходят 
обносок: обносках 
брат: братьев 
неувязочка: неувязочка неувязочек 
момент: моменте моменты 
ваньш: ваньша 
ставить: ставила 
корректный: корректную 
детальный: детальную 
экономист: экономист экономисты 
многое: многое 
закладывать: заложено 
гп: гп 
изменять: изменить 
черта: чертах 
отлично: отлично 
rainbow: rainbow 
pony: pony 
отредактировать: отредактировано 
каков: каков 
смысл: смысла смысл 
существование: существования 
пытаться: пыталась 
прогуглить: прогуглить 
борьба: борьба 
зло: злом 
магла: маглам 
никакой: никакого 
человечество: человечества 
совершать: совершать 
открытие: открытия 
саморазвиваться: саморазвиваться 
тд: тд 
сродни: сродни 
данность: данность 
особенный: особенные 
особенность: особенности 
рассказ: рассказах 
миссия: миссия 
основное: основном 
давать: дают 
четко: четко 
осознавать: осознать 
мол: мол 
всякий: всякого всякий 
г: г 
воевать: воюем 
защищать: защищаем 
остальной: остальной 
мать: мать 
мыть: моет моют 
чистить: чистит 
посуда: посуду 
вязать: вяжущие 
спица: спицы 
содержанка: содержанка 
александра: александра 
русова: русова 
руководить: руководить 
victoria: victoria 
tores: tores 
посудомойка: посудомойкой 
стиралка: стиралкой 
комбайн: комбайном 
мультиварка: мультиваркой 
татьяна: татьяна 
держать: держать 
фокус: фокусе 
внимание: внимания 
навык: навыках 
бедно: бедно 
должное: должное 
палатка: палаткой 
итд: итд 
dg: dg 
отличный: отличная отличное 
спасибо: спасибо 
огромный: огромное 
недавно: недавно 
обсуждать: обсуждали 
стоимость: стоимость стоимости 
залотой: залотой 
эквивалент: эквивалента 
магл: маглов 
значит: значит 
галлен: галлена 
олег: олег 
соколенко: соколенко 
критически: критически 
элизер: элизер 
начало: начале 
абзац: абзац 
размышление: размышлений 
отделять: отделена 
магловский: магловских магловской 
понятие: понятия 
арбитражный: арбитражных 
гораздо: гораздо 
постоянно: постоянно 
отличаться: отличался 
пять: пять 
процент: процентов проценты 
семнадцать: семнадцати 
вымываться: вымывалось 
пока: пока 
постоянный: постоянный 
становиться: станет становилось 
невозможный: невозможным 
приносить: принести 
сикать: сикли 
сначала: сначала 
вика: вика 
заясь: заясь 
прикол: прикол 
работник: работник 
класс: класс 
сухарь: сухари 
сергей: сергей 
разин: разин 
исследование: исследование 
богомерзкий: богомерзкий 
программист: программист 
англия: англии 
забывать: забыли 
маглый: маглы 
гермиона: гермиона 
принадлежность: принадлежности 
обменник: обменник 
валюта: валют 
львиный: львиная 
доля: доля доли 
род: рода 
exchange: exchange 
сарказм: сарказмом 
внутри: внутри 
новое: новое 
интересный: интересное 
прожженный: прожженным 
александр: александр 
мжельский: мжельский 
нормально: нормально 
дурсль: дурслями 
несостыковка: несостыковок 
странность: странностей 
книжка: книжка 
читать: читать 
относительно: относительно 
зрелый: зрелом 
alex: alex 
freeman: freeman 
мошенник: мошенникам 
понадобиться: понадобились 
справка: справки 
репетитор: репетитор 
полагаться: полагался 
каникулы: каникулы 
инвалидность: инвалидностью 
копить: копить 
балл: баллы 
уведомлять: уведомлять 
счет: счет счетах 
белоруссия: белоруссии 
ипать: ип 
молодой: молодой 
оформлять: оформить 
машина: машину 
быть: будут 
сотрудничать: сотрудничают 
сосед: соседи 
заливать: залили 
дверной: дверную 
ручка: ручку 
клей: клеем 
протест: протест 
завещание: завещание 
муж: мужа 
проблема: проблемы проблеме 
багаж: багажом 
поездка: поездках 
косметичка: косметичка 
уход: уход 
чувствительный: чувствительной 
комбинированный: комбинированной 
кожа: кожей 
акна: акне 
продавец: продавец 
вносить: внесет 
вернуть: вернуть 
отрабатывать: отработала 
срок: срок 
целевой: целевому 
договор: договор договору 
застревать: застряла 
таможня: таможне 
стаут: стауты 
гоза: гозе 
ламбик: ламбики 
пить: пить 
крафтовый: крафтовое 
пиво: пиво 
москва: москве 
бали: бали 
зарплата: зарплатой 
въезд: въезда 
сербия: сербию 
россиянин: россиян 
поколение: поколение 
девяностый: девяностых 
лишний: лишнее 
рынок: рынке 
беспроводный: беспроводные 
колонка: колонки 
удачный: удачных 
модель: моделей 
директор: директор 
розничный: розничной 
поволжье: поволжье 
дежурный: дежурный 
электромонтер: электромонтер 
новосибирск: новосибирске 
тратить: тратила 
классный: классные 
впечатление: впечатления 
apple: apple 
watch: watch 
вакансия: вакансии 
сообщать: сообщить 
проект: проекте 
контакт: контакты 
политика: политика 
конфиденциальность: конфиденциальности 
ао: ао 
лицензия: лицензия 
