мнение: мнением мнения мнение 
поколение: поколении поколению поколения поколение 
девяностый: девяностых 
лишний: лишнее лишним 
рынок: рынок рынке рынка 
труд: труде трудом труда труд 
промой: промо 
бесплатный: бесплатной бесплатная бесплатным 
кредитка: кредитка 
промокод: промокоду 
fgo: fgo 
давать: дать дадут дай дал давайте даст давали дают 
учебник: учебник 
сравнятор: сравнятор 
сообщество: сообществе сообщество 
ипотека: ипотека 
кредитный: кредитная 
история: история 
тест: тесты 
дневник: дневники дневник дневника 
трата: трат 
налоговый: налоговые налоговую налоговый 
вычет: вычет 
написать: написать написали написанным написан 
инвестиция: инвестиции 
бизнес: бизнес бизнеса 
разбор: разборы 
закон: законов 
калькулятор: калькуляторы 
путешествие: путешествия 
медицина: медицина 
здоровье: здоровье 
недвижимость: недвижимость 
подкаста: подкасты 
видео: видео 
смотреть: смотрю смотреть 
сервис: сервисы 
расчет: расчеты 
закладка: закладки 
письмо: письма 
оставаться: оставайтесь осталась 
деньги: деньгами деньги денег 
поток: потоки 
текст: текст 
бережно: бережно 
отредактировать: отредактирован отредактировано 
оформлять: оформить оформлен 
стандарт: стандартам 
редакция: редакция редакции 
александр: александр 
искать: ищет искать ищем ищешь 
свое: свое 
место: место месте места мест 
мир: мире мира мир 
профиль: профиль 
автор: автора автор автору 
дорогой: дорогая дорогой 
читатель: читатели читатель читателя 
год: год годов годы годами году годе годам лет года годах 
рождение: рождения 
задумываться: задумывался 
какой: какое какие каком 
профессия: профессий профессия профессиях профессиям профессию профессии 
твой: твоего твои 
окружение: окружение окружении окружения 
иметь: имеющие имея имею иметь имел 
вид: виде виду 
который: который которые которых которого которая которыми котором которое которым которому 
ровесник: ровесники 
работать: работаешь работает работала работаю работают работая работать работал работающих 
оканчивать: окончили окончил 
колледж: колледжи колледже колледж 
вуз: вузы вуз вузов вуза 
неправда: неправда 
среди: среди 
юрист: юрист юристы юриста юристов юристом 
экономист: экономистов экономист 
журналист: журналист журналистов журналисты 
архитектор: архитекторов архитекторы архитектор 
дизайнер: дизайнеров дизайнеры 
барист: бариста 
курьер: курьеров курьеры курьерами 
сборщик: сборщиков сборщики 
оператор: операторы 
колцентр: колцентров 
продавец: продавцы продавец продавца 
кассир: кассиры кассиров 
другой: другие других другого 
должность: должность должности должностях 
квалификация: квалификацией квалификация квалификации 
низкий: низких низкой низкую 
каждый: каждый каждым 
минимум: минимум 
мечтать: мечтал 
специальность: специальности специальностях специальность 
пойти: пойдет пошли пошел пойти 
взять: взятом взяли взяла возьмут 
почему: почему 
рано: раньше 
наш: нашего наше 
оказываться: окажетесь оказалось 
высокий: высокими высшего высшему высшее высшей высокая высокой 
рождаемость: рождаемость рождаемости 
человек: человеком человека люди людьми людях людей человеку человек 
успевать: успели 
получать: полученным получи получить получать получили получает получило полученной 
квалифицированный: квалифицированным квалифицированную квалифицированное 
работа: работах работе работу работы работа 
возникать: возникали возникла 
пресловутый: пресловутая 
яма: яма яму 
власть: власти власть 
отменять: отменили 
распределение: распределение распределении 
эйчары: эйчары эйчарам 
начинать: начали начинали начал начинала 
просить: прошу просить 
опыт: опыте опыт опыта опытом 
избыток: избытком 
хватать: хватает 
опытный: опытных 
работодатель: работодателям работодатели работодателю работодатель 
никакой: никакого никаким 
смысл: смысла смысле 
брать: беру брать берут 
неопытный: неопытных 
ребенок: дети детей ребенку 
учить: учить 
тратить: тратила тратить 
ресурс: ресурсы 
компания: компании компаниях компанию 
наставник: наставника 
нести: нести 
риск: риски 
обучать: обучишь 
новичок: новичка 
уходить: уйдет ушла 
полно: полно 
безработный: безработный безработных 
практически: практически 
недоступный: недоступна 
пример: пример примерах 
исключение: исключения исключение 
медик: медиков 
учитель: учителей 
военный: военных 
нужный: нужны нужна нужным нужное 
любой: любую любого любое любой любом 
кризис: кризис 
вредный: вредных 
убеждение: убеждений 
мешать: мешают 
сменить: сменить 
одновременно: одновременно 
это: этому это этим 
россия: россия россии 
страна: страну страны 
производство: производством 
превращаться: превратилась 
сырьевой: сырьевую 
отсталый: отсталую 
жить: живущую живет 
газ: газом 
нефть: нефтью 
один: одни одного одно одном 
приходиться: приходится пришлось 
тысяча: тысяча тысяч 
постоянно: постоянно 
спор: споры 
учиться: учиться учился учились учатся 
ребята: ребятам ребята 
сказать: сказали сказала скажу сказал сказать 
неутешительный: неутешительное 
равно: равно 
случай: случаев 
мочь: могу можете могли можем 
потратить: потратив 
никто: никто никому 
нынче: нынче 
образование: образованию образованием образования образование 
касаться: касается 
модный: модных 
инфоцыганский: инфоцыганских 
курс: курсов 
вестись: ведитесь 
поучиться: поучиться поучитесь 
далеко: далеко дальше 
просто: просто проще 
предвидеть: предвижу 
комментарий: комментарии 
стиль: стиле 
стажер: стажером стажерами 
бесплатно: бесплатно 
уборщица: уборщицы 
сделать: сделают сделайте сделанного сделали 
выход: выход выхода выходе 
друг: друзьями друзьям 
куча: кучу куча 
диплом: дипломам дипломов диплома дипломом дипломы диплом 
везде: везде 
упираться: упирается упрется 
требование: требование 
рабочий: рабочее рабочих 
такой: такая такого такому такое таких такие такую 
повар: повар 
машинист: машинист 
называть: называемых 
элитный: элитных элитным 
далее: далее 
надеяться: надеемся 
находиться: найдется находится найдутся 
ковид: ковид 
сво: сво 
плохо: плохо хуже 
становиться: становится стать стал стало 
стареть: стареют 
идти: шла идти иди шли идут 
кайф: кайф 
староватый: староваты 
давно: давно 
мало: мало меньше 
принимать: примет 
мера: мере меры 
несчастный: несчастного 
доставаться: досталось 
голодный: голодное 
детство: детство 
безработица: безработица 
юность: юности 
старший: старшим старшее старшего 
возраст: возрасту возраст возраста 
тот: те той ту 
кто: кем кому кого 
везти: повезло 
проскочить: проскочить 
понимать: понимала поймут поняла 
неблизкий: неблизким 
врать: вру 
хотеть: хотел хочет хотят хотите хочу 
выслушивать: выслушивать 
поработать: поработав поработай 
выходной: выходные 
гад: гад 
халявный: халявное 
жилье: жилье 
путевка: путевки 
стипендия: стипендии 
жизнь: жизни жизнь 
дорожать: дорожает 
день: днем дня 
все: всеми всем всё 
выгрызать: выгрызаем 
сам: самого сама сами 
мы: нам 
часто: чаще часто 
заканчиваться: заканчивается заканчивались 
дурак: дурака 
согласный: согласен согласного согласна 
потрудиться: потрудиться 
делиться: делятся 
мысль: мыслями 
тема: тему 
высказываться: высказаться 
подписываться: подписаться 
тэг: тэги 
учеба: учеба 
иллюстратор: иллюстратор 
аня: аня 
кольцов: кольцова 
готовый: готовое готов готова готовы 
поспорить: поспорить 
поделиться: поделитесь 
проходить: пройти проходим проходят 
модерация: модерацию 
правило: правилам правила 
журнал: журнала журнале 
герой: герой 
мой: мои моем моего моё 
программист: программистом программист программисты 
лингвист: лингвисты 
большинство: большинство 
оплачивать: оплачиваемых 
многие: многие 
отличный: отличную 
карьера: карьеру карьере карьеры 
очень: очень 
грустно: грустно 
свой: своей свои свой своему своим 
неудача: неудачи 
объяснять: объясняете 
дело: дел деле дело 
отвечать: ответить 
даниил: даниил 
ермоленко: ермоленко 
похоже: похоже 
попытка: попытку 
сваливать: свалить 
ответственность: ответственности ответственность 
phd: phd 
sabina: sabina 
плюсовать: плюсую 
данные: данные 
вообще: вообще 
сходиться: сходятся 
утроенный: утроенно 
гибкий: гибким 
быстроадаптебельный: быстроадаптебельным 
мышление: мышлением мышление 
любить: любят 
достигать: достигать 
потреблять: потреблять 
созидать: созидать 
вопросик: вопросики 
низкоквалифицированный: низкоквалифицированный низкоквалифицированных 
зашоривать: зашоренными 
взгляд: взглядами взгляд 
тд: тд 
спиваться: спившихся 
скалываться: сколовшиеся сколовшихся 
именно: именно 
зашкаливать: зашкаливает 
ekaterina: ekaterina 
porvatova: porvatova 
абсолютно: абсолютно 
обобщать: обобщать 
зависеть: зависит 
скорость: скорости 
данный: данного 
процесс: процесс процесса 
некоторый: некоторое 
время: времена время времени 
плохой: плохом плохого 
расти: расти росли 
развиваться: развиваться развивались 
егэ: егэ 
поступать: поступишь поступай поступить поступало 
начитанный: начитанных 
поэтому: поэтому 
полный: полная полную полного 
чушь: чушь 
значит: значит 
ваш: ваши вашем 
вопрос: вопрос вопросов 
общаться: общаетесь 
взаимодействовать: взаимодействуете 
говорить: говорю говорить говоря говорят говорит 
прямо: прямо 
выборка: выборка 
официальный: официальная 
статистика: статистика 
писать: писала пишете 
развитие: развития 
рост: росте роста рост 
зп: зп 
обучение: обучение обучением обучения 
новый: новым новых 
скилла: скиллам 
осуждать: осуждают 
миллениал: миллениалов 
зумер: зумеров 
скакать: скачут 
переходить: переходят перешел 
улучшенить: улучшеним 
условие: условий 
рабский: рабского 
менталитет: менталитета 
гораздо: гораздо 
точка: точке 
накопать: накопали 
отдельно: отдельно 
завод: заводе 
интересно: интересно 
социологический: социологических 
исследование: исследований 
user: user 
статья: статье статьи 
незашоривать: незашоренное 
андрей: андрей 
титов: титов 
понятно: понятно 
очевидно: очевидно 
героиновый: героинового 
бум: бум бума 
десяток: десятки 
удивлять: удивляет 
логика: логика 
imya: imya 
familiya: familiya 
самый: самая самое самом самый самых 
невероятно: невероятно 
менеджер: менеджеры 
мария: мария 
полностью: полностью 
рождаться: родившихся родились родилась 
неплохо: неплохо 
зарабатывать: зарабатываю 
дмитрий: дмитрий 
нормально: нормально 
разнообразный: разнообразные 
владимир: владимир 
клименков: клименков 
представитель: представитель 
тола: толой 
успех: успехов успехе 
дружище: дружище 
неспокойный: неспокойном 
il: il 
razzz: razzz 
инфантильный: инфантильную инфантильное 
крыло: крыло 
сталкиваться: столкнулись 
реальность: реальностью реальность 
stubborn: stubborn 
triangle: triangle 
миллинеал: миллинеалы 
alina: alina 
judkina: judkina 
секундочка: секундочку 
говориться: говорится 
около: около 
lazex: lazex 
позиция: позицию позициях позиции 
пытаться: пытается 
хотя: хотя 
точно: точно точнее 
дурочка: дурочки 
бесполезный: бесполезные 
быть: будут будучи будешь 
бред: бред 
школьник: школьника школьники 
студент: студентов студентами студентом студент 
третий: третьего 
спокойно: спокойно 
устраиваться: устроиться устроился 
техник: техник техником 
второй: второй вторая второе 
категория: категории 
предварительно: предварительно 
лето: летом 
отрабатывать: отработала отработав 
месяц: месяца 
окончание: окончания 
инженер: инженеры инженером инженеров инженер инженера 
период: период 
аспирантура: аспирантуре 
таки: таки 
младший: младшим 
научный: научного научными научным 
сотрудник: сотрудника сотрудников сотрудником 
защищать: защитил защищать 
кандидатский: кандидатскую 
сразу: сразу 
связь: связи 
результат: результатов результатами 
проблема: проблем проблемы проблема проблеме 
ведущий: ведущего 
главный: главного 
планировать: планирую 
докторский: докторскую 
публикация: публикаций публикации 
опус: опус 
магнум: магнум 
доводить: довести 
ум: ума 
полноценный: полноценным 
гнс: гнс 
претендовать: претендовать 
ученый: ученое ученого 
звание: звание 
профессор: профессора 
аналогично: аналогично 
франция: франции 
германия: германии 
краткосрочный: краткосрочно 
подрабатывать: подрабатывал 
приглашать: приглашенного 
центр: центрами 
фрг: фрг 
несмотря: несмотря 
особенность: особенности 
поддерживать: поддержу поддерживаю 
прошлый: прошлой 
неделя: неделе неделю 
созваниваться: созванивались 
скайп: скайпе 
повод: поводу 
очередной: очередной 
совместный: совместной 
дурачок: дурачок 
баристый: баристой 
посылка: посылка 
почтовый: почтовая 
сила: силами сил силой 
упорство: упорством 
забирать: забрать забирают 
причем: причем 
современный: современным 
положение: положением 
система: системе 
ибо: ибо 
фактический: фактическое 
подушевой: подушевое 
финансирование: финансирования финансирование 
университет: университете университетах университетов 
заставлять: заставляет 
отчислять: отчислять 
безнадежный: безнадежных безнадежные 
баранов: баранов 
поскольку: поскольку 
приводить: приведет 
сокращение: сокращению 
гоголь: гоголя 
мертвый: мертвые 
душа: души душой 
тупой: тупые 
идиотский: идиотские 
богиня: богиня 
драматизм: драматизма 
крик: крике 
отсутствовать: отсутствует 
упоминание: упоминание 
инженерный: инженерных 
треть: треть 
рука: руки 
задница: задницы 
evgrin: evgrin 
красиво: красиво 
борьба: борьбе 
черчиль: черчиль 
обещать: обещал 
народ: народу народ народа 
великобритания: великобритании 
пот: пот 
кровь: кровь 
побеждать: победить 
гитлер: гитлера 
слеза: слезу 
anna: anna 
poliakova: poliakova 
верно: верно 
прекрасный: прекрасный 
хороший: хорошая хороший лучшие хорошей хорошее хороших хорошего хорошую 
квартира: квартиры квартиру 
раздавать: раздают 
лекарь: лекарь 
видимо: видимо 
считать: считает считаете 
государство: государства 
устраивать: устроено 
выходить: вышли выходишь выходили выйти 
институт: института институты институт 
ты: тебе 
соцпакет: соцпакет 
бочка: бочку 
варение: варенья 
сергей: сергей 
разин: разин 
ник: ник 
averyanova: averyanova 
добиваться: добились 
зарплата: зарплатой зарплат зарплату 
обязанный: обязан 
кажется: кажется 
сначала: сначала 
подставлять: подставить 
необходимый: необходимое 
портфолио: портфолио 
имя: имя 
владимиш: владимиш 
пресс: пресс 
репутация: репутацию репутация 
борисов: борисов 
заканчивать: закончила заканчивал закончили 
нулевой: нулевые нулевых нулевым 
давный: давным 
забывать: забыли 
предприятие: предприятии предприятия 
трудоустройство: трудоустройстве 
многий: многих 
родитель: родители родителей 
личный: личном личные 
небольшой: небольшой небольших 
город: городе городах 
отличие: отличии 
бухгалтер: бухгалтера 
прямой: прям 
конец: конце 
вряд: вряд 
предлагать: предложить предложили 
курсы: курсы 
малахов: малахов 
технология: технологии технологий 
активно: активно 
осваиваться: осваивались 
иностранный: иностранным иностранные 
бе: бе 
ме: ме 
язык: языке 
компьютер: компьютерах 
подход: подходе подхода 
заставать: застали 
руководящий: руководящий 
состав: состав 
руководить: руководит 
массово: массово 
soledad: soledad 
заблуждение: заблуждение 
возможно: возможно 
сторона: стороне 
хотеться: хочется 
вначале: вначале 
копейка: копейки 
построить: построишь 
шаг: шаг 
переступать: переступите 
гордость: гордость 
показывать: покажите показывать 
вкладываться: вкладываться 
иначе: иначе 
неинтересно: неинтересно 
проигрыш: проигрыше 
барахтаться: барахтается 
странный: странным 
энтузиаст: энтузиастом 
выбирать: выбирая выбрал 
малоперспективный: малоперспективную 
пока: пока 
одногруппник: одногруппники 
угодно: угодно 
перебирать: перебирать 
наиболее: наиболее 
перспективный: перспективных 
помогать: помогать 
сдаваться: сдались 
заранее: заранее 
мако: мако 
сакурай: сакураи 
описывать: описывает 
добавлять: добавлю 
тенденция: тенденцию тенденция 
умирать: умри 
желательно: желательно 
особо: особо 
спрашивать: спрашивал 
нужно: нужно 
конкретный: конкретном конкретному 
цена: ценой 
видно: видно 
отсюда: отсюда 
явление: явление 
молодежь: молодежь 
осознанно: осознанно 
относиться: относится 
выбор: выбору 
условный: условные 
получаться: получается получилось получалось 
принцип: принципу 
звучать: звучит звучало 
школа: школах школы школу 
понятие: понятия 
интернет: интернет интернете 
информация: информации 
почерпать: почерпнуть 
справочник: справочник 
адрес: адресами 
участвовать: участвовали 
итог: итоге 
получение: получение получению 
поступление: поступления 
численность: численности 
педагогический: педагогический 
огромный: огромных огромный огромного огромное 
количество: количества количество 
столица: столице 
сибирь: сибири 
еслич: есличе 
пед: педе пед 
лишь: лишь 
ничтожный: ничтожный 
процент: процент проценты 
бумище: бумище 
помнить: помнят помню 
распложаться: расплодились 
всякий: всякие всяких 
частный: частные 
обеспечивать: обеспечивали 
спрос: спрос 
вышка: вышки вышку вышке 
паника: паника 
общество: обществе 
мол: мол 
кидаться: кидались 
осознание: осознания 
соответственно: соответственно 
факт: факту 
желающий: желающие 
абсурдно: абсурдно 
вспоминать: вспоминать 
корочка: корочки 
кмк: кмк 
знать: знали знаю знать 
подавляться: подавлялось 
жыть: жыть 
выбираться: выбирались 
вариант: варианты 
бог: бог 
мастер: мастер 
маникюр: маникюра 
снобизм: снобизма 
отношение: отношение отношению 
имхо: имхо 
морковка: морковка 
кроме: кроме 
изменяться: изменилось 
план: плане плану 
стараться: стараются 
макар: макаром 
легко: легче легко 
сдавать: сдал сдать 
тупо: тупо 
натаскивать: натаскать 
заграница: заграницей 
видеть: вижу 
адекватный: адекватное 
прежде: прежде 
причина: причины 
первый: первые первое первый 
считаться: считается 
упоминать: упомянули 
важно: важно 
главное: главное 
небезызвестный: небезызвестная 
авторша: авторша 
однажды: однажды 
коммент: комментах 
полиция: полиции 
уважение: уважения 
задавать: задают 
весь: весь 
ответ: ответ 
простой: простые 
советский: советские 
возможность: возможность возможностей 
заветный: заветный 
важный: важнее 
рф: рф 
действительно: действительно 
невозможно: невозможно 
бывать: бывают 
оно: оно 
обязательно: обязательно 
грубо: грубо 
приходить: прийти приходят 
момент: момент 
потолок: потолок 
обувать: обута 
замечательный: замечательный 
взрослый: взрослые 
заочек: заочке 
порочный: порочный 
круг: круг 
корень: корне 
пересматривать: пересмотреть 
рядить: рядя 
вакансия: вакансий вакансии 
убирать: убрать 
наличие: наличие 
mmm: mmm 
базовый: базовыми базовое 
технический: техническое 
экономический: экономическое 
юридический: юридическое 
медицинский: медицинское 
ита: ит 
базис: базисе 
самостоятельно: самостоятельно 
наращиваться: наращивается 
кругозор: кругозор 
обучаемость: обучаемости 
поставлять: поставленную поставить поставлен поставлять 
цель: цель 
екатерина: екатерина 
сестра: сестра 
блюдечко: блюдечке 
разбираться: разбираться 
тп: тп 
модно: модно 
отличник: отличником 
хорошист: хорошистом 
круто: круто 
списывать: списать 
выкручиваться: выкрутиться 
свободный: свободное 
тусить: тусить 
мутный: мутных 
еще: ещё 
раз: разу 
госэкзамен: госэкзамен 
поинтересоваться: поинтересоваться 
зато: зато 
трясти: трясти 
жаловаться: жаловаться жалуются 
несправедливость: несправедливости 
сложно: сложно сложнее 
следующий: следующем 
многое: многом 
отдельный: отдельные 
отличаться: отличающиеся 
личность: личности 
скоро: скорее 
студия: студию 
танец: танца 
салон: салон 
красота: красоты 
находить: найти 
администратор: администратора администратор 
звонок: звонках 
свидетель: свидетелем 
завал: завал 
перспектива: перспектива 
залипать: залипает 
телефон: телефоне 
полдень: полдня 
делать: делать 
шея: шее 
посидеть: посидим 
ноль: ноль 
желание: желания желание желанию 
готовность: готовности 
велить: велена 
оч: оч 
сильно: сильно 
извиняться: извиняюсь 
что: чему 
думать: думала думаете 
род: род 
деятельность: деятельности 
заниматься: заниматься 
крайний: крайней 
относить: отношу 
тип: типу 
регулярно: регулярно 
чуточку: чуточку 
разный: разные 
вещь: вещи 
каста: касте 
элита: элите 
химик: химиков 
физик: физиков 
врач: врачей 
прочий: прочих 
прощение: прощения 
невъебенный: невъебенным 
рядом: рядом 
стоять: стояло 
попробовать: попробуйте 
расскзаывать: расскзаывать 
админ: админом 
malinche: malinche 
подросток: подростком 
пик: пик 
класс: классов 
параллель: параллели 
конкурс: конкурс 
конкурировать: конкурировали 
солнце: солнцем 
привыкать: привыкли 
рассчитывать: рассчитывать 
подряд: подряд 
вводить: вводили 
недобор: недобор 
общий: общем 
vladislav: vladislav 
основывать: основанная 
доказывать: доказывает 
коммунист: коммунист 
очередь: очереди 
продукт: продуктами 
постоять: постоять 
век: век 
самореализация: самореализации 
хватить: хватит 
жалеть: жалеть 
карьерный: карьерный 
юлия: юлия 
мухохин: мухохина 
здравствовать: здравствуй 
дорастать: доросла 
начальник: начальника начальник 
отдел: отдела 
изначально: изначально 
практика: практике 
параллельно: параллельно 
сидеть: сидеть 
инспектор: инспектором 
никуда: никуда 
вырастать: вырасти выросшему 
пахать: пахать 
большой: больших большую большом 
фирма: фирму 
меньший: меньшее меньшую 
госслужба: госслужбы 
знание: знания 
запись: запись 
трудовой: трудовой 
книжка: книжке 
повышать: повышают повысил повысили 
даваться: далось 
выть: выла 
усталость: усталости 
моральный: моральной 
физический: физической 
соглашаться: согласившись 
будущее: будущем 
больший: большее 
выпускник: выпускников 
москва: москве москва москвы 
платить: платил платит 
ниже: ниже 
затем: затем 
высокооплачиваемый: высокооплачиваемую 
повышение: повышение 
текущий: текущей 
анни: анни 
м: м 
пристыжать: пристыдил 
остальной: остальные 
слишком: слишком 
завышать: завышенная 
планка: планка 
богатый: богатые 
содержать: содержать 
напыщенный: напыщенный 
лоб: лоб 
федоренко: федоренко 
картина: картина 
подходить: подходит 
описание: описание 
бедный: бедных 
депрессивный: депрессивных 
регион: регионах 
маленький: маленьких 
пункт: пунктах 
промышленность: промышленности 
бок: боком 
набегать: набежали 
житель: жители 
питер: питера 
благополучный: благополучных 
таксист: таксистам 
башковитый: башковитым 
полагать: положившим 
сложный: сложное 
выучиваться: выучиться 
курчатовский: курчатовских 
профильный: профильной 
попадать: попасть 
нии: нии 
тыс: тыс 
оклад: оклада 
вокруг: вокруг 
должный: должен 
рассыпаться: рассыпаться 
злободневный: злободневный 
отечественный: отечественной 
микроэлектроника: микроэлектроники 
стыд: стыд 
запрос: запросу 
ангстрем: ангстрем 
willkommen: willkommen 
правда: правда 
правдоподобный: правдоподобно 
долорес: долорес 
баста: баста 
начало: начале начало 
офигевать: офигевали 
собеседование: собеседования 
ждать: ждут ждет 
аида: аида 
марсельевна: марсельевна 
сплошной: сплошные 
лузер: лузеры 
дочь: дочь 
г: г 
р: р 
настоящий: настоящее 
крупный: крупном 
лизинговый: лизинговом 
холдинг: холдинге 
одноклассник: одноклассники 
сегодня: сегодня 
редактор: редактор 
девочка: девочка 
проектировщик: проектировщик 
успешный: успешная успешной успешные 
парень: парень 
строительный: строительное 
эколог: эколог 
солерс: солерс 
фармацевт: фармацевт 
шоколад: шоколаде 
торг: торг 
дружественный: дружественной 
индийский: индийской 
формация: формации 
объездить: объездила 
сын: сын 
входить: входит 
диапазон: диапазон 
контора: конторе 
недождаться: недождется 
менее: менее 
кейс: кейсы 
троешница: троешница 
мед: мед 
училище: училище 
топовый: топовый 
массажист: массажист 
мелвик: мелвик 
речь: речь 
обычный: обычной 
якобы: якобы 
способность: способности 
понимание: понимание 
заработок: заработков заработком 
старт: старте 
заясь: заясь 
извинять: извините 
вылепливать: вылепили 
реально: реально 
предыдущий: предыдущему 
многочисленный: многочисленному 
нелегкая: нелегкие 
повторять: повторить 
последующий: последующему 
пенсионный: пенсионный 
некого: некого 
сменять: сменять 
lyuba: lyuba 
увы: увы 
таков: такова 
достаточный: достаточных 
содержание: содержания 
начинающий: начинающие 
специалист: специалисты 
стартовый: стартовой стартовую 
гроши: гроши 
баснословный: баснословные 
сверстник: сверстников 
спустя: спустя 
околосредний: околосредним 
гросс: гросс 
достаточно: достаточно 
комфортный: комфортного 
уровень: уровня 
мошенник: мошенникам 
понадобиться: понадобились 
справка: справки 
репетитор: репетитор 
полагаться: полагался 
каникулы: каникулы 
налог: налог налоги 
инвалидность: инвалидностью 
копить: копить 
покупать: покупать 
балл: баллы 
уведомлять: уведомлять 
счет: счет счетах 
белоруссия: белоруссии 
работник: работник 
товар: товары 
ипать: ип 
молодой: молодой 
машина: машину 
сотрудничать: сотрудничают 
сосед: соседи 
заливать: залили 
дверной: дверную 
ручка: ручку 
замок: замок 
клей: клеем 
протест: протест 
ремонт: ремонта 
завещание: завещание 
муж: мужа 
имущество: имущество 
стоимость: стоимости 
здание: здание 
баланс: баланс 
рассказывать: расскажите 
багаж: багажом 
поездка: поездках 
косметичка: косметичка 
уход: уход 
чувствительный: чувствительной 
комбинированный: комбинированной 
кожа: кожей 
акна: акне 
последствие: последствия 
покупатель: покупателя 
вносить: внесет 
доля: доли 
сколько: сколько 
вернуть: вернуть 
срок: срок 
целевой: целевому 
договор: договор договору 
составлять: составить 
популярный: популярное 
застревать: застряла 
таможня: таможне 
стаут: стауты 
гоза: гозе 
ламбик: ламбики 
пить: пить 
крафтовый: крафтовое 
пиво: пиво 
бали: бали 
въезд: въезда 
сербия: сербию 
россиянин: россиян 
беспроводный: беспроводные 
колонка: колонки 
удачный: удачных 
модель: моделей 
директор: директор 
розничный: розничной 
сеть: сети 
поволжье: поволжье 
дежурный: дежурный 
электромонтер: электромонтер 
новосибирск: новосибирске 
несколько: несколько 
классный: классные 
впечатление: впечатления 
apple: apple 
watch: watch 
сообщать: сообщить 
проект: проекте 
контакт: контакты 
политика: политика 
конфиденциальность: конфиденциальности 
пользование: пользования 
сайт: сайтом 
ао: ао 
банк: банк 
лицензия: лицензия 
