инвестиционный: инвестиционные 
разбор: разборы 
обзор: обзоры 
акция: акции акций 
компания: компании компаний компания 
аналитика: аналитика 
финансовый: финансового 
рынок: рынок рынке рынка 
бизнес: бизнес бизнеса 
учебник: учебник 
сравнятор: сравнятор 
сообщество: сообщество 
ипотека: ипотека 
кредитный: кредитная 
история: история 
тест: тесты 
дневник: дневники дневник 
трата: трат 
налоговый: налоговый 
вычет: вычет 
написать: написать 
инвестиция: инвестиции инвестициях 
закон: законов 
калькулятор: калькуляторы 
путешествие: путешествия 
медицина: медицина 
здоровье: здоровье 
недвижимость: недвижимость недвижимости 
подкаста: подкасты 
видео: видео 
смотреть: смотреть 
сервис: сервисы 
расчет: расчеты 
закладка: закладки 
письмо: письма 
оставаться: оставайтесь 
деньги: деньгами 
поток: потоки 
инвестразбор: инвестразборы 
разбирать: разбираем 
который: которые 
интересовать: интересуют 
рассказывать: расскажем 
зарабатывать: зарабатывает 
кто: кого 
какой: какую какие каких 
долг: долги 
стоять: стоит 
инвестировать: инвестировать 
очень: очень 
никита: никита 
компанищенко: компанищенко 
российский: российских российские 
бумага: бумаг 
избавляться: избавлялись 
крупный: крупные 
акционер: акционеры 
год: год году года 
сергей: сергей 
шаболкин: шаболкин 
вклад: вклад 
интересный: интереснее 
краткосрочный: краткосрочные 
облигация: облигаций облигации 
прикупать: прикупить 
портфель: портфель 
роман: роман 
романович: романович 
отчет: отчет 
фокус: фокус 
эффективность: эффективности 
почитать: почитать 
начинающий: начинающих 
новость: новости 
инвестор: инвесторам инвестор инвесторов 
инвестидея: инвестидеи 
николай: николай 
валюха: валюх 
инфляция: инфляция 
сша: сша 
плохо: хуже 
ожидание: ожиданий 
праздник: праздник 
михаил: михаил 
болд: болдов 
игра: игры 
неликвид: неликвидом 
третий: третьего 
эшелон: эшелона 
разгонять: разгоняли 
февраль: феврале 
квартал: квартал 
зафиксировать: зафиксировала 
падение: падение 
продажа: продажи продаж 
отрасль: отрасли 
получать: получить получили 
господдержка: господдержку 
россия: россии 
заканчиваться: закончился 
ждать: ждать 
вячеслав: вячеслав 
макаренко: макаренко 
ммк: ммк 
экспорт: экспорт 
обвалиться: обвалился 
внутренний: внутренний 
спрос: спрос 
устаивать: устоял 
евгений: евгений 
шепелев: шепелев 
совет: советы 
финансы: финансах 
популярный: популярные 
книга: книги 
против: против 
экономический: экономической 
теория: теории 
норвежский: норвежский 
фонд: фонд 
благосостояние: благосостояния 
потерять: потерял 
млрд: млрд 
доллар: долларов 
вывод: выводы 
сделать: сделать 
банк: банк 
сеть: сеть 
гостиница: гостиниц 
купить: купили 
продавать: продали 
месяц: месяца 
стаценко: стаценко 
медицинский: медицинского 
стартап: стартапа 
покупать: покупать 
доходность: доходностью доходность 
дитя: дитя 
доход: доходов 
страшно: страшно 
перспектива: перспективы 
фрс: фрс 
подымать: подняла 
ставка: ставку 
восьмой: восьмой 
некоторые: некоторые 
индикатор: индикаторы 
говорить: говорят 
рецессия: рецессии 
рекордный: рекордные 
показатель: показатели 
кризис: кризис 
появляться: появится 
новый: новый новая 
валюта: валюта 
брикс: брикс 
повлиять: повлияет 
рубль: рублей рубль 
допэмиссия: допэмиссия 
втб: втб 
превышать: превысить 
игорь: игорь 
морошкин: морошкин 
гипермаркет: гипермаркеты 
увядать: увядают 
дискаунтер: дискаунтеры 
расти: растут 
урок: уроки 
извлекать: извлечь 
дефолт: дефолтов 
вадим: вадим 
кизимов: кизимов 
слабый: слабые 
результат: результаты 
обещание: обещание 
перерегистрация: перерегистрации 
лср: лср 
конец: концу 
восстанавливаться: восстановились 
вкус: вкуса 
готовить: готовит 
выпуск: выпуск 
общий: общей 
многие: многие 
ожидать: ожидаемо 
снижаться: снизились 
вакансия: вакансии 
сообщать: сообщить 
проблема: проблеме 
проект: проекте 
контакт: контакты 
политика: политика 
конфиденциальность: конфиденциальности 
правило: правила 
пользование: пользования 
сайт: сайтом 
выходить: выйти 
ао: ао 
лицензия: лицензия 
