покупка: покупка покупки покупкой покупке 
втб: втб 
соглашение: соглашение 
uber: uber 
другой: другая другие других другими 
сделка: сделке сделку сделках сделка сделки 
российский: российские российская российский российских российском российского 
компания: компаний компании компаниями компанию компания 
промой: промо 
дарить: дарит 
акция: акции акций 
регистрация: регистрацию 
мочь: могу 
получать: получить получил получать получили 
учебник: учебник 
сравнятор: сравнятор 
сообщество: сообщество 
ипотека: ипотека 
кредитный: кредитная 
история: история 
тест: тесты 
дневник: дневники дневник 
трата: трат 
налоговый: налоговые налоговую налоговый 
вычет: вычет 
написать: написать 
инвестиция: инвестиции инвестициях инвестициями 
бизнес: бизнесов бизнес бизнеса 
разбор: разборы 
закон: законов 
калькулятор: калькуляторы 
путешествие: путешествия 
медицина: медицина 
здоровье: здоровье 
недвижимость: недвижимость 
подкаста: подкасты 
видео: видео 
смотреть: смотреть 
сервис: сервис сервисы сервисов 
расчет: расчеты 
закладка: закладки 
письмо: письма 
оставаться: оставшихся оставшиеся оставайтесь 
деньги: деньгами деньги денег 
поток: потоки 
инвестразбор: инвестразборы 
банк: банк 
сеть: сети сеть 
гостиница: гостиниц 
купить: купил купили купить 
продавать: продали продал 
месяц: месяца 
yandex: yandex 
yndx: yndx 
р: р 
афк: афк 
система: система 
afks: afks 
газпром: газпром 
нефть: нефть нефти 
sibn: sibn 
vtbr: vtbr 
ростелеком: ростелеком 
rtkm: rtkm 
партнерство: партнерстве 
тинькофф: тинькофф 
котировка: котировки 
обновляться: обновляются 
минута: минут 
рынок: рынок рынке рынка 
слияние: слияний 
поглощение: поглощений 
резко: резко 
оживать: ожил 
предновогодний: предновогодний 
период: период 
мосбиржа: мосбирже мосбиржи мосбиржа 
объявлять: объявить объявила объявили 
новый: новому новой новую новых 
актив: активы актив активов актива активу 
рф: рф 
общий: общая общую 
сумма: сумма сумму 
около: около 
млрд: млрд 
рубль: рублей 
кроме: кроме 
четверка: четверки 
один: одному одну одним 
мегасделка: мегасделку 
объем: объемом 
вероятно: вероятно 
готовить: готовит 
госхолдинг: госхолдинга госхолдинг 
который: который которой которые которая которое 
хотеть: хочет 
поглощать: поглотить 
свой: свой своей своего 
близкий: ближайшего ближайшее 
конкурент: конкурента 
рассказывать: рассказываем расскажите 
крупный: крупных крупнейшим крупное 
отреагировать: отреагировал 
никита: никита 
компанищенко: компанищенко 
частный: частная частный 
инвестор: инвесторам инвестор инвесторов 
профиль: профиль 
автор: автора 
второй: второй 
размер: размеров размерам 
работать: работает работала 
практически: практически 
все: всем 
постсоветский: постсоветском 
пространство: пространстве 
конец: конец конце 
год: год лет году года 
банковский: банковский банковского 
присутствовать: присутствовал 
страна: странах 
россия: россия россии 
германия: германия 
великобритания: великобритания 
грузия: грузия 
армения: армения 
беларусь: беларусь 
казахстан: казахстан казахстане 
азербайджан: азербайджан 
кипр: кипр 
ангола: ангола 
китай: китай 
индия: индия 
сингапур: сингапур 
декабрь: декабря 
закрывать: закрыл 
цб: цб 
группа: группы группа группу 
организация: организация 
заплатить: заплатить заплатит 
облигация: облигациями 
федеральный: федерального 
заем: займа 
данный: данных данным 
рыночный: рыночной 
оценка: оценка оценке 
p: p 
bv: bv 
вдвое: вдвое 
текущий: текущей текущего 
показатель: показатели показателя 
такой: такая 
существенный: существенная 
разница: разница 
объясняться: объясняется 
высокий: высокий высокой 
рентабельность: рентабельность рентабельностью 
приобретать: приобретя приобретаемых приобретаемого 
наличие: наличием наличия 
чистый: чистой чистая чистый 
прибыль: прибыли прибыль 
итог: итогам итоге 
зарабатывать: заработает 
свыше: свыше 
рсба: рсбу 
мсфо: мсфо 
отрицательный: отрицательная 
сторона: сторона 
приходиться: придется пришлось 
проведение: проведении 
допэмиссия: допэмиссии допэмиссия 
рамка: рамках 
привлекать: привлечь 
превышать: превышающую превысить превысит 
ждать: ждать 
мультипликатор: мультипликаторы мультипликаторам 
сектор: секторе сектора 
капитализация: капитализации капитализация 
e: e 
сбербанк: сбербанк 
tcs: tcs 
group: group 
банка: банка 
источник: источники источник 
делать: делать 
хороший: лучшие лучшее 
неделя: неделю 
ваш: вашей 
почта: почте 
каждый: каждый 
понедельник: понедельник 
бесплатно: бесплатно 
подписываться: подписаться подписывайтесь 
ведущий: ведущий 
поисковик: поисковиком 
множество: множеством множества 
оператор: оператор оператора 
такси: такси 
приложение: приложения 
доставка: доставки 
продукт: продуктов 
маркетплейс: маркетплейс 
прочий: прочие 
перспективный: перспективные 
подразделение: подразделения 
февраль: феврале 
сми: сми 
договариваться: договорился 
mlu: mlu 
млн: млн 
доллар: долларов 
время: время 
должно: должно 
поступать: поступить 
правительственный: правительственная правительственную 
спецкомиссия: спецкомиссия спецкомиссию 
одобрение: одобрения 
это: этому это 
совместный: совместном совместное 
предприятие: предприятии предприятие 
этот: этих 
два: двух 
эмитент: эмитентов эмитента 
владеть: владеет 
оказываться: окажется 
создавать: создали 
изначально: изначально 
немой: нем 
остальной: остальная 
часть: часть 
будущее: будущем 
должный: должна должны 
отходить: отойти 
менеджмент: менеджменту 
увеличивать: увеличила 
доля: доли долю 
опцион: опцион 
выкуп: выкуп 
бумага: бумаг 
получаться: получается 
смог: смог 
сэкономить: сэкономить 
миллиард: миллиарда 
новость: новости новость 
полностью: полностью 
отыгрывать: отыграли 
фондовый: фондовом 
вырастать: выросли 
примерно: примерно 
тот: те 
инвестиционный: инвестиционная 
портфель: портфель 
состоять: состоит 
основной: основными основной 
считаться: считаются 
телекоммуникационный: телекоммуникационный телекоммуникационная телекоммуникационных телекоммуникационном 
ozon: ozon 
строительный: строительная 
лесопромышленный: лесопромышленный 
холдинг: холдинга холдинг 
segezha: segezha 
агрохолдинг: агрохолдинг 
медицинский: медицинская 
фармпроизводитель: фармпроизводитель 
cosmos: cosmos 
hotel: hotel 
дочерний: дочернее 
заключать: заключила 
отель: отеля отелей 
норвежский: норвежской 
wenaas: wenaas 
бренд: брендами 
park: park 
inn: inn 
radisson: radisson 
blu: blu 
olympia: olympia 
garden: garden 
географический: географическое 
расположение: расположение 
находиться: находятся 
располагаться: располагаются 
москва: москве 
объект: объекту 
мурманск: мурманске 
екатеринбург: екатеринбурге 
соответствовать: соответствует 
тысяча: тысячи 
квадратный: квадратный 
метр: метр 
гостиничный: гостиничный 
фактически: фактически 
удваиваться: удвоится 
сделать: сделает 
объединять: объединенную 
лидер: лидеров 
местный: местного 
суммарный: суммарный 
фонд: фонд 
номер: номеров 
выручка: выручка 
возрастать: возрасти 
заинтересовываться: заинтересовалась 
калужский: калужского 
завод: завода 
volkswagen: volkswagen 
цель: целью 
создание: создания 
база: базе 
машиностроительный: машиностроительного 
рассчитывать: рассчитывает 
проект: проекте проект 
автопроизводитель: автопроизводителя 
allur: allur 
собирать: собирает 
машина: машину машины 
китайский: китайской 
марка: марки 
jac: jac 
энергетический: энергетическое 
заниматься: занимается 
разведка: разведкой 
разработка: разработкой 
месторождение: месторождений месторождение 
газ: газа 
нефтепереработка: нефтепереработкой 
производство: производством 
реализация: реализацией 
нефтепродукт: нефтепродуктов 
рубеж: рубежом 
акционер: акционерами акционер 
британский: британская 
нефтедобывающий: нефтедобывающая 
shell: shell 
продажа: продаже 
ооо: ооо 
разрабатывать: разрабатывает 
салымский: салымское 
автономный: автономном 
округ: округе 
западный: западной 
сибирь: сибири 
согласовывать: согласовать 
считать: считать 
завершать: завершенной 
раскрываться: раскрывается 
интерес: интерес 
проявлять: проявляла 
судоходный: судоходная 
wellnord: wellnord 
c: c 
управлять: управляет 
небольшой: небольших небольшим 
флот: флотом 
нефтяной: нефтяных 
химический: химических 
танкер: танкеров 
число: числе числа 
ледовый: ледового 
класс: класса 
зарубежный: зарубежный 
претендент: претендентов претендента претендент 
квартал: квартала 
предлагать: предлагал 
евро: евро 
государственный: государственный 
провайдер: провайдер 
цифровой: цифровых 
услуга: услуг 
занимать: занимает 
лидировать: лидирующие 
позиция: позиции 
высокоскоростной: высокоскоростного 
доступ: доступа 
интернет: интернет 
интерактивный: интерактивного 
телевидение: телевидения 
мобильный: мобильной 
связь: связи 
хранение: хранения 
обработка: обработки 
также: также 
кибербезопасность: кибербезопасности 
начало: начале 
ссылка: ссылкой 
анонимный: анонимные 
сообщать: сообщить сообщил 
отправлять: отправил 
согласование: согласование 
правительство: правительству 
вопрос: вопрос 
usm: usm 
сильный: сильными 
финансовый: финансовые финансовыми 
результат: результатов результатами результаты 
частное: частного 
oibda: oibda 
долг: долг 
недавно: недавно 
проходить: прошла проходят 
veon: veon 
годовой: годовой 
ebitda: ebitda 
предполагать: предположить 
стоимость: стоимость стоимости 
уровень: уровне 
мнение: мнению мнение 
аналитик: аналитиков 
большой: большого 
собственник: собственнику 
отдавать: отдать 
зависимость: зависимости 
непрофильный: непрофильных 
сравнение: сравнение сравнении 
ev: ev 
мтс: мтс 
мгтс: мгтс 
приводить: привести 
рост: росту 
наиболее: наиболее 
сильно: сильно 
увеличиваться: увеличатся 
возможно: возможно 
последний: последнему 
удаваться: удастся 
зафиксировать: зафиксируют 
меньший: меньший 
эффект: эффект 
приобретение: приобретений 
касаться: касаются 
наш: нашем 
курс: курсе 
происходить: происходящего 
тэг: тэги 
открытие: открытие 
яндекс: яндекс 
фотография: фотография 
обложка: обложке 
fifg: fifg 
shutterstock: shutterstock 
комментарий: комментарии 
модерация: модерацию 
правило: правилам правила 
журнал: журнала 
мошенник: мошенникам 
понадобиться: понадобились 
справка: справки 
репетитор: репетитор 
полагаться: полагался 
каникулы: каникулы 
платить: платил 
налог: налог налоги 
человек: человеку человек 
инвалидность: инвалидностью 
копить: копить 
покупать: покупать 
балл: баллы 
уведомлять: уведомлять 
счет: счет счетах 
белоруссия: белоруссии 
работник: работник 
поставлять: поставлять поставить 
товар: товары 
работодатель: работодателю 
ипать: ип 
молодой: молодой 
оформлять: оформить 
какой: какие 
риск: риски 
быть: будут 
сотрудничать: сотрудничают 
иностранный: иностранным 
сосед: соседи 
заливать: залили 
дверной: дверную 
ручка: ручку 
замок: замок 
клей: клеем 
протест: протест 
ремонт: ремонта 
завещание: завещание 
ребенок: дети детей 
муж: мужа 
имущество: имущество 
здание: здание 
баланс: баланс 
проблема: проблемы проблеме 
багаж: багажом 
возникать: возникали 
поездка: поездках 
косметичка: косметичка 
уход: уход 
чувствительный: чувствительной 
комбинированный: комбинированной 
кожа: кожей 
акна: акне 
последствие: последствия 
покупатель: покупателя 
продавец: продавец 
вносить: внесет 
сколько: сколько 
вернуть: вернуть 
обучение: обучение 
отрабатывать: отработала 
срок: срок 
целевой: целевому 
договор: договор договору 
составлять: составить 
процент: проценты 
популярный: популярное 
посылка: посылка 
застревать: застряла 
таможня: таможне 
стаут: стауты 
гоза: гозе 
ламбик: ламбики 
место: мест 
пить: пить 
крафтовый: крафтовое 
пиво: пиво 
жить: живет 
бали: бали 
зарплата: зарплатой 
въезд: въезда 
сербия: сербию 
россиянин: россиян 
поколение: поколение 
девяностый: девяностых 
лишний: лишнее 
труд: труда 
беспроводный: беспроводные 
колонка: колонки 
удачный: удачных 
модель: моделей 
директор: директор 
розничный: розничной 
поволжье: поволжье 
экономист: экономист 
дежурный: дежурный 
электромонтер: электромонтер 
новосибирск: новосибирске 
несколько: несколько 
тратить: тратила 
классный: классные 
впечатление: впечатления 
apple: apple 
watch: watch 
вакансия: вакансии 
контакт: контакты 
политика: политика 
конфиденциальность: конфиденциальности 
пользование: пользования 
сайт: сайтом 
выходить: выйти 
ао: ао 
лицензия: лицензия 
