подборка: подборка 
материал: материалов 
учебник: учебник 
сравнятор: сравнятор 
сообщество: сообщество 
ипотека: ипотека 
кредитный: кредитная 
история: история 
тест: тесты 
дневник: дневники дневник 
трата: трат 
налоговый: налоговый 
вычет: вычет 
написать: написать 
инвестиция: инвестиции 
бизнес: бизнес 
разбор: разборы 
закон: законов 
калькулятор: калькуляторы 
путешествие: путешествия 
медицина: медицина 
здоровье: здоровье 
недвижимость: недвижимость 
подкаста: подкасты 
видео: видео 
смотреть: смотреть 
сервис: сервисы 
расчет: расчеты 
закладка: закладки 
письмо: письма 
оставаться: оставайтесь 
деньги: деньгами 
поток: потоки 
никита: никита 
компанищенко: компанищенко 
инвестразбор: инвестразборы 
какой: каких 
российский: российских 
бумага: бумагам бумаги бумаг 
избавляться: избавлялись 
крупный: крупные 
акционер: акционеры 
год: годом год году 
евгений: евгений 
шепелев: шепелев 
новость: новости 
инвестор: инвесторов 
оборот: оборот обороты 
мосбиржа: мосбирже мосбиржа 
январь: январе 
список: список 
самый: самые самых 
популярный: популярные популярных 
иностранный: иностранных иностранным 
вадим: вадим 
кизимов: кизимов 
итог: итоги 
торги: торги торгов 
план: планы 
развитие: развитию 
воодушевлять: воодушевили 
роман: роман 
романович: романович 
полупроводниковый: полупроводниковый 
сектор: сектор 
китай: китая 
зарабатывать: заработать 
перспективный: перспективной 
отрасль: отрасли 
раскрывать: раскрыла 
другой: другие 
ноябрь: ноябре 
октябрь: октябрь 
упасть: упал упали 
сравнение: сравнению 
ранее: ранее 
держаться: держится 
возобновлять: возобновит 
выплата: выплату 
дивиденд: дивидендов 
petrochina: petrochina 
sinopec: sinopec 
chalco: chalco 
china: china 
life: life 
новый: новые 
гонконгский: гонконгские 
акция: акции 
игорь: игорь 
морошкин: морошкин 
сезон: сезона 
отчетность: отчетности 
красавчик: красавчик 
кто: кого 
большой: большие 
проблема: проблемы проблеме 
московский: московская 
сильно: сильнее 
сентябрь: сентябре сентября 
быть: будут 
торговаться: торговаться 
рубль: рубли 
работать: работать 
ограничение: ограничение 
страна: стран 
август: августе 
вакансия: вакансии 
сообщать: сообщить 
проект: проекте 
контакт: контакты 
политика: политика 
конфиденциальность: конфиденциальности 
правило: правила 
пользование: пользования 
сайт: сайтом 
выходить: выйти 
ао: ао 
банк: банк 
лицензия: лицензия 
