правило: правила правило 
поведение: поведение поведения 
стоять: стоит 
делать: делайте делать 
комментарий: комментарий комментарии комментария комментариям комментариях комментариев 
промой: промо 
заклинание: заклинание 
бесплатный: бесплатную 
кредитка: кредитку 
fgo: fgo 
заказывать: заказать 
карта: карту 
учебник: учебник 
сравнятор: сравнятор 
сообщество: сообщество 
ипотека: ипотека 
кредитный: кредитная 
история: историю история 
тест: тесты 
дневник: дневники дневник 
трата: трат 
налоговый: налоговые налоговую налоговый 
вычет: вычет 
написать: напишите написать 
инвестиция: инвестиции 
бизнес: бизнес бизнеса 
разбор: разборы 
закон: законов 
калькулятор: калькуляторы 
путешествие: путешествия 
медицина: медицина 
здоровье: здоровье 
недвижимость: недвижимость 
подкаста: подкасты 
видео: видео 
смотреть: смотреть 
сервис: сервисы 
расчет: расчеты 
закладка: закладки 
письмо: письма 
оставаться: оставайтесь 
деньги: деньгами деньги денег 
поток: потоки 
способ: способах способов способ 
схлопотать: схлопотать 
бан: бан бана банов 
полиция: полиция 
бдеть: бдит 
профиль: профиле профиль профиля профили 
автор: автора авторы автор авторов 
это: это 
млн: млн 
человек: человека люди людей человеку человек 
комментатор: комментаторы комментаторов 
герой: героев героя героем герои 
журнал: журнала журнал 
этот: этих 
мнение: мнением мнений мнение 
который: который которые которую которая котором которое 
отличаться: отличаться 
ваш: вашего ваш вашей ваше вашем 
стремиться: стремимся 
площадка: площадкой площадок площадка 
отображать: отображает 
множество: множество 
точка: точка точек точку 
зрение: зрения 
поэтому: поэтому 
бережно: бережно 
относиться: относимся относятся 
ко: ко 
все: всем 
стараться: старайтесь стараемся 
банить: банить 
пользователь: пользователь пользователя пользователи пользователей 
лишний: лишнее лишний 
случаться: случаются 
ситуация: ситуации ситуация 
участник: участники 
обсуждение: обсуждений 
перегибать: перегибают 
палка: палку 
крайний: крайних 
мера: мера мер меры 
обходиться: обойтись 
документ: документе 
описывать: описываем 
случай: случаи случае 
срок: срок сроки 
памятка: памятка 
нарушитель: нарушителей 
рассказывать: рассказывает рассказываем расскажите 
модератор: модераторов модератор модераторы модератора 
определять: определяет 
блокировка: блокировки блокировка 
объяснять: объясняем объяснить 
сделать: сделать 
забанить: забанили забанены забанить 
реклама: рекламы реклама рекламу 
пиар: пиаре пиар 
рекомендательный: рекомендательные 
ссылка: ссылки ссылок 
приветствоваться: приветствуются 
рассказ: рассказы 
полезный: полезных 
проект: проекте проектах 
тема: теме темы тема 
материал: материала материал материалами 
содержать: содержит 
явный: явную 
удалять: удален удалено удалим 
отправлять: отправлен отправлять отправить 
пожизненный: пожизненный 
быть: будут будьте 
аккуратный: аккуратны 
делиться: делиться делятся делитесь 
контакт: контактами контакты 
многие: многие 
проходить: проходят 
модерация: модерацию 
мочь: могут можем 
заподозривать: заподозрить 
пытаться: пытаться пытайтесь 
оставлять: оставлять 
контактный: контактные 
данные: данные 
свой: своей своими своем свой своя своим своих 
никнейм: никнейме никнеймами 
равно: равно 
замечать: заметим 
решать: решите решили 
откорректировать: откорректировать 
вернуть: вернуть 
подозрительный: подозрительную подозрительной 
информация: информации информацию 
обратно: обратно 
риск: риск риски 
оказываться: оказаться окажется 
заблокировать: заблокирован 
поиск: поиске поиска 
клиент: клиентов 
расширение: расширения 
аудитория: аудитории 
наш: наши 
подозрение: подозрения 
подтверждаться: подтвердятся 
отправляться: отправится отправляются отправиться отправятся 
право: права право 
реабилитация: реабилитацию 
слишком: слишком 
похоже: похоже 
часть: часть 
дискуссия: дискуссий дискуссию дискуссии 
сообщение: сообщения 
нарушать: нарушающие нарушает 
законодательство: законодательство 
рф: рф 
обычно: обычно 
призыв: призывы 
насилие: насилию 
разжигание: разжигание 
межнациональный: межнациональной 
рознь: розни 
возбуждение: возбуждение 
ненависть: ненависти 
отношение: отношению отношений 
группа: группы группе 
лицо: лиц 
торговать: торгующих 
запрещать: запрещенными 
вещество: веществами 
универсальный: универсальный 
набор: набор 
читатель: читатели читатель читателей читателя 
хотеть: хотите хочет 
гарантированный: гарантированно 
политический: политическую политические политических 
распоряжаться: распоряжаются 
выходить: выйти выходить 
рамка: рамки 
контекст: контекста 
существовать: существует 
сайт: сайте сайт сайтом 
заниматься: занимайтесь 
агитация: агитации агитацией 
разводить: разводите 
место: место месте мест 
пусть: пусть 
интернет: интернете 
хотя: хотя 
островок: островок 
свободный: свободный 
баталия: баталий 
понимать: понимаем поймут 
некоторые: некоторые 
неразрывный: неразрывно 
связанный: связаны 
политика: политика политикой 
действовать: действуем 
систематически: систематически 
настойчиво: настойчиво 
продвигать: продвигает 
позиция: позицию позиции 
вмешиваться: вмешаться 
недалеко: недалеко 
прямой: прямое 
оскорбление: оскорбления оскорбление 
согласный: согласны 
страшный: страшного 
нормально: нормально 
каждый: каждого 
один: одним одного одних 
близкий: близок близка 
другой: другие других 
счесть: сочтут 
неприемлемый: неприемлемой неприемлемые неприемлемое 
например: например 
предпочитать: предпочитает предпочитают 
передвигаться: передвигаться 
город: городу 
машина: машину машине 
общественный: общественном 
транспорт: транспорте 
использовать: использует использовать используют 
разный: разные разными 
средство: средства 
передвижение: передвижения 
вовсе: вовсе 
значит: значит 
автомобилист: автомобилисты 
должный: должны 
унижать: унижающие унижать 
тот: тех той теми 
автобус: автобус 
наоборот: наоборот 
также: также 
советовать: советуем 
оскорблять: оскорблять 
знакомый: знакомых 
незнакомый: незнакомых 
целый: целые 
социальный: социальные 
критиковать: критикуют критикуйте 
конструктивно: конструктивно 
предлагать: предлагайте 
аргумент: аргументы 
личный: личным 
опыт: опытом 
забывать: забывайте 
манера: манерах 
поспорить: поспорить 
достоинство: достоинством 
хамство: хамство 
домысел: домыслами домыслы 
переход: переход 
личность: личность личности 
помогать: поможет помогут 
доказывать: доказать 
правота: правоту 
лишь: лишь 
испортить: испортят 
карма: карму 
публиковать: публикуют публикуйте 
неплохо: неплохо 
очень: очень 
травля: травля 
деанонимизация: деанонимизация 
агрессивный: агрессивное агрессивной 
преследование: преследование 
недопустимо: недопустимо 
воздерживаться: воздержитесь 
публикация: публикации публикацию 
реальный: реальных 
имя: имени имен именем имя 
номер: номеров 
телефон: телефона 
почта: почты 
соцсеть: соцсетях соцсети 
работа: работы 
учеба: учебы 
публично: публично 
раскрывать: раскрывают 
персональный: персональные 
пожелать: пожелавшего 
сохранять: сохранить 
анонимность: анонимность 
токсичный: токсичное 
текст: текстов текст тексты 
вызывать: вызывают 
бурный: бурные 
эмоция: эмоции 
глубина: глубины 
душа: души 
возмущать: возмущает 
статья: статья статьи 
образ: образа образ 
жизнь: жизни 
третий: третьи 
видеть: видят 
провокация: провокацию 
спешить: спешите 
нести: нести 
свое: свое 
возмущение: возмущение 
начинать: начала 
убеждаться: убедитесь 
поговорить: поговорить 
существо: существу 
обсуждать: обсудить 
сэкономить: сэкономить 
покупка: покупке 
квартира: квартиры 
осуждать: осуждать 
финансовый: финансовые 
привычка: привычки привычек 
прочитывать: прочитали 
нужно: нужно 
повод: поводу 
вы: вами 
начисление: начислении 
алименты: алиментов 
устраивать: устраивайте 
битва: битву 
пол: полов 
ради: ради 
внешность: внешности 
увлечение: увлечений 
далее: далее 
сказать: сказать 
аккуратно: аккуратнее 
выбор: выборе 
формулировка: формулировок 
сложно: сложно 
удерживаться: удержаться 
гнев: гнева 
досчитывать: досчитайте 
перечитывать: перечитайте 
интонация: интонацией 
вкладывать: вкладывали 
грубовато: грубовато 
неплохой: неплохой 
пример: пример 
критика: критики 
перебор: перебор 
флуд: флуд 
убедительно: убедительно 
высказывать: высказать 
спор: споре 
постараться: постарайтесь 
взвешивать: взвесить 
разом: разом 
намного: намного 
поступать: поступить 
забрасывать: забрасывать 
оппонент: оппонентам оппонента 
десяток: десятками 
отдельный: отдельных 
источник: источники 
утомлять: утомляет 
никто: никому 
нравиться: нравится 
пролистывать: пролистывать 
ветка: ветку 
сто: ста 
адекватный: адекватных 
ответ: ответов 
находить: находить 
поощрять: поощряем 
дублирование: дублирование 
чужой: чужих 
аргументировать: аргументированную аргументировать 
помощь: помощь помощью 
научный: научного 
исследование: исследования 
излагать: изложить 
суть: суть 
слово: словами 
копировать: копировать 
весь: весь 
распространяться: распространяется 
поделиться: поделиться 
размышление: размышлениями 
причина: причину причине 
отклонять: отклонил 
проявлять: проявлять 
излишний: излишнюю 
настойчивость: настойчивость 
повторно: повторно 
надежда: надежде 
одобрять: одобрят 
изучать: изучите изучат 
отклонение: отклонения 
учитывать: учтите 
пожелание: пожелания 
шанс: шансов шанс 
услышать: услышанным 
выбирать: выбираете выберут выбрана 
путь: путь 
спамер: спамера 
готовиться: готовьтесь 
баня: бане 
ненормативный: ненормативная 
лексика: лексика 
мат: мата мат 
злоупотреблять: злоупотребляйте 
нежелательно: нежелательно 
такой: таком 
становиться: стать 
ноль: нулю 
кроме: кроме 
иметь: имеет иметь 
полный: полное 
отредактировать: отредактировать 
накрутка: накрутка накрутку накрутки 
лайков: лайков 
дизлайков: дизлайков 
создание: создание 
мультиаккаунт: мультиаккаунты мультиаккаунтов 
пользоваться: пользуется 
популярность: популярностью 
звать: звать 
команда: команду 
сторонник: сторонников 
поддерживать: поддержит поддержать 
лайко: лайком 
оглушать: оглушит 
дизлайка: дизлайками 
несогласный: несогласных 
редакция: редакция 
рассекречивать: рассекретит рассекретим 
проницательный: проницательные 
дело: дело 
нечисто: нечисто 
вечный: вечный 
инициатор: инициатор 
акция: акции 
вместо: вместо 
весть: вести 
открывать: открываете 
массировать: массированную 
атака: атаку 
соперник: соперников 
намеренно: намеренно 
портить: портите 
считаться: считается 
рекомендовать: рекомендуем 
создавать: создавать создают 
новый: новые 
аккаунт: аккаунта аккаунт аккаунты аккаунтов 
собственный: собственную 
активность: активность 
принимать: примем 
одинаковый: одинаковым 
случайно: случайно 
дважды: дважды 
регистрироваться: регистрируются 
происходить: произошла 
подобный: подобная 
просто: просто 
объединять: объединить 
однако: однако 
несколько: несколько 
корыстный: корыстных 
цель: целях 
аргументация: аргументации 
спам: спама 
сразу: сразу 
изображение: изображения изображение 
помнить: помните 
любой: любое 
нарушение: нарушении нарушений 
текстовый: текстовым 
графический: графическим 
обязательно: обязательно 
обманывать: обмануть 
система: систему 
фотография: фотографии 
аватарка: аватарке 
неприличный: неприличное 
логотип: логотип 
компания: компании 
временно: временно 
заменять: заменить 
фото: фото 
плохо: плохо 
вести: ведет 
внимательно: внимательно 
действие: действий 
приемлемый: приемлемую 
комбинация: комбинацию 
качество: качество качестве 
пресечение: пресечения 
удаление: удаление 
временный: временная 
постоянный: постоянный постоянная 
свертывать: свернули 
скользкий: скользкую 
дорожка: дорожку 
впервые: впервые 
неделя: неделю 
профилактика: профилактики 
надеяться: надеемся 
вывод: выводы 
повторный: повторном 
увеличивать: увеличен 
высокий: высшая 
наказание: наказания 
дополняться: дополняться 
обновляться: обновляться 
необходимо: необходимо 
повышать: повысить 
препятствовать: препятствовать 
распространение: распространению 
токсичность: токсичности 
общаться: общаться 
приятно: приятнее 
подписываться: подписаться 
мошенник: мошенникам 
понадобиться: понадобились 
справка: справки 
репетитор: репетитор 
полагаться: полагался 
каникулы: каникулы 
платить: платил 
налог: налог налоги 
инвалидность: инвалидностью 
копить: копить 
покупать: покупать 
балл: баллы 
уведомлять: уведомлять 
счет: счет счетах 
белоруссия: белоруссии 
работник: работник 
поставлять: поставлять поставить 
товар: товары 
работодатель: работодателю 
ипать: ип 
молодой: молодой 
оформлять: оформить 
какой: какие 
сотрудничать: сотрудничают 
иностранный: иностранным 
сосед: соседи 
заливать: залили 
дверной: дверную 
ручка: ручку 
замок: замок 
клей: клеем 
протест: протест 
ремонт: ремонта 
завещание: завещание 
ребенок: дети детей 
муж: мужа 
получать: получать получили 
имущество: имущество 
стоимость: стоимости 
здание: здание 
баланс: баланс 
проблема: проблемы проблеме 
багаж: багажом 
возникать: возникали 
поездка: поездках 
косметичка: косметичка 
уход: уход 
чувствительный: чувствительной 
комбинированный: комбинированной 
кожа: кожей 
акна: акне 
последствие: последствия 
покупатель: покупателя 
продавец: продавец 
вносить: внесет 
доля: доли 
сколько: сколько 
обучение: обучение 
отрабатывать: отработала 
целевой: целевому 
договор: договор договору 
составлять: составить 
процент: проценты 
популярный: популярное 
посылка: посылка 
застревать: застряла 
таможня: таможне 
стаут: стауты 
гоза: гозе 
ламбик: ламбики 
пить: пить 
крафтовый: крафтовое 
пиво: пиво 
москва: москве 
жить: живет 
бали: бали 
зарплата: зарплатой 
въезд: въезда 
сербия: сербию 
россиянин: россиян 
год: лет году 
поколение: поколение 
девяностый: девяностых 
рынок: рынке 
труд: труда 
хороший: лучшие 
беспроводный: беспроводные 
колонка: колонки 
удачный: удачных 
модель: моделей 
директор: директор 
розничный: розничной 
сеть: сети 
поволжье: поволжье 
экономист: экономист 
дежурный: дежурный 
электромонтер: электромонтер 
новосибирск: новосибирске 
тратить: тратила 
классный: классные 
впечатление: впечатления 
apple: apple 
watch: watch 
вакансия: вакансии 
сообщать: сообщить 
конфиденциальность: конфиденциальности 
пользование: пользования 
ао: ао 
банк: банк 
лицензия: лицензия 
