акция: акциями акциях акции акциям акций 
третий: третьего третий 
эшелон: эшелона эшелонов 
разгонять: разгоняли 
рынок: рынок рынке рынка 
ценный: ценных ценными ценным 
бумага: бумагам бумагами бумагах бумаг 
февраль: феврале февраля 
промой: промо 
дарить: дарит 
регистрация: регистрацию 
мочь: могу могло 
получать: получить получать получили 
учебник: учебник 
сравнятор: сравнятор 
сообщество: сообщества сообщество 
ипотека: ипотека 
кредитный: кредитная 
история: история 
тест: тесты 
дневник: дневники дневник 
трата: трат 
налоговый: налоговые налоговую налоговый 
вычет: вычет 
написать: написать 
инвестиция: инвестиции инвестициями 
бизнес: бизнес бизнеса 
разбор: разборы 
закон: законов 
калькулятор: калькуляторы 
путешествие: путешествия 
медицина: медицина 
здоровье: здоровье 
недвижимость: недвижимость 
подкаста: подкасты 
видео: видео 
смотреть: смотреть 
сервис: сервис сервисы 
расчет: расчеты 
закладка: закладки 
письмо: письма 
оставаться: остается оставайтесь 
деньги: деньгами деньги денег 
поток: потоки 
инвестразбор: инвестразборы 
игра: игры 
неликвид: неликвидом 
почему: почему 
это: это 
ненормально: ненормально 
московский: московской московская 
биржа: биржа бирже биржи 
moex: moex 
р: р 
купить: купить 
партнерство: партнерстве 
тинькофф: тинькофф 
котировка: котировок котировками котировки 
обновляться: обновляются 
минута: минут 
аномальный: аномальном аномальные 
движение: движения движение 
отдельный: отдельных 
невысокий: невысокой 
ликвидность: ликвидностью ликвидности 
начинаться: начались 
первый: первых 
день: день дней 
работа: работы 
новый: новом 
год: лет году 
динамика: динамика 
походить: походила 
спекулятивный: спекулятивный 
разгон: разгона разгон 
стратегия: стратегии 
pump: pump 
dump: dump 
сброс: сброс 
январь: январе 
журнал: журнал журнала 
упоминать: упомянутого упоминал 
кейс: кейсы 
такой: такие таком такое таких 
манипуляция: манипуляций манипуляции 
становиться: стать стало 
жертва: жертвой 
подозрительный: подозрительные подозрительная 
операция: операции 
продолжаться: продолжились 
второй: второго 
стремительно: стремительно 
расти: растут 
падать: падают 
аномально: аномально 
высокий: высокой высоких 
оборот: оборотах оборота обороту обороте 
говорить: говорит говорить 
пытаться: пытается 
манипулировать: манипулировать 
среда: среду 
октябрь: октября 
чкпз: чкпз 
входить: входит вошли 
пятерка: пятерку 
лидер: лидеров 
торговый: торговом торговых торговому 
уступать: уступили 
обыкновенный: обыкновенным обыкновенные 
сбербанк: сбербанка 
законный: законно 
стоять: стоит 
отмечать: отметить 
весь: вся 
четверка: четверка 
котировальный: котировальный котировальных 
список: списках список 
относиться: относится 
наиболее: наиболее 
низкий: низкой 
общий: общая 
капитализация: капитализация 
начало: началом 
ниже: ниже 
который: которые которых которого которая котором которым 
оказываться: оказалось оказались 
один: одном 
конкурентный: конкурентном 
поле: поле 
вырастать: выросли выросла 
привилегированный: привилегированные 
подорожать: подорожали 
соответственно: соответственно 
инвестор: инвесторам инвесторы инвестор инвесторов 
виноватый: виноват 
наказывать: наказан 
устраивать: устроена устроят 
инсайдерский: инсайдерская 
торговля: торговле торговля торговли 
россия: россии россией 
сша: сша 
нормальный: нормальных 
условие: условиях 
скачка: скачки 
возможный: возможны 
сенсационный: сенсационных 
новость: новости новость новостей 
сверхуспех: сверхуспехах 
информационный: информационном 
абсолютный: абсолютный 
штиль: штиль 
происходить: произошедшее происходящего происходит 
явный: явная 
очень: очень 
аномалия: аномалия 
михаил: михаил 
болд: болдов 
частный: частных частный 
профиль: профиль 
автор: автора 
курс: курсе курс 
общаться: общаться 
понимать: понимать 
друг: друг друга 
бесплатный: бесплатный 
бережно: бережно 
окружающий: окружающими 
часто: чаще часто 
желать: желаемое 
изучать: изучить 
отреагировать: отреагировала отреагировали отреагировал 
выпускать: выпустила 
короткий: короткий 
пост: пост 
обращать: обратила 
внимание: внимание 
повышенный: повышенную повышенных 
волатильность: волатильность волатильности 
некоторые: некоторых 
рекомендовать: рекомендовали 
принимать: принимать 
взвешивать: взвешенные 
решение: решения 
покупка: покупке 
продажа: продаже 
учет: учетом 
официальный: официальной 
информация: информации 
профучастник: профучастников 
сам: самих 
эмитент: эмитентов 
самый: самой самым 
косвенно: косвенно 
подтвердить: подтвердила подтвердили 
факт: факт факту 
искусственный: искусственный искусственного 
предупреждение: предупреждения 
очевидно: очевидно 
недостаточно: недостаточно 
следующий: следующее следующий 
национальный: национальный 
клиринговый: клиринговый 
центр: центр 
группа: группу 
ограничивать: ограничила ограничил ограничено 
верхний: верхнее 
максимальный: максимальное 
значение: значение 
отклонение: отклонения отклонение 
цена: цен цены 
заявка: заявок 
четыре: четырех 
компания: компаний 
ранее: ранее 
ограничение: ограничение 
составлять: составить составляло 
падение: падение падении падением 
регулятор: регулятор 
цб: цб 
функция: функции 
расследование: расследование 
выявление: выявление 
фондовый: фондовом фондовой 
пока: пока 
ограничиваться: ограничился 
комментарий: комментарии комментарием 
рбк: рбк 
сообщать: сообщив сообщить 
связывать: связывает 
резкий: резкое резкий 
изменение: изменение 
ряд: ряде ряд 
доля: доля доли долей 
участие: участия 
торги: торгах торгов 
директор: директор 
департамент: департамента 
противодействие: противодействия 
недобросовестный: недобросовестным 
практика: практикам 
валерий: валерий 
лях: лях 
передавать: передал 
скачкообразный: скачкообразное 
повышение: повышение 
фон: фоне 
доминирование: доминирования 
фактор: факторов 
влиять: влиять 
объем: объема 
отдельность: отдельности 
совокупно: совокупно 
концентрация: концентрация 
определенный: определенные 
часы: часы 
например: например 
открытие: открытия 
снижение: снижение 
другой: другие других 
отсутствие: отсутствие 
действительно: действительно 
секция: секции 
резко: резко 
прошлое: прошлом 
взаимный: взаимной 
блокировка: блокировки 
актив: активов 
страна: странами 
иностранный: иностранным иностранные 
включая: включая 
крупный: крупные 
институциональный: институциональные 
фонд: фонды 
переставать: перестали 
торговать: торговать 
российский: российских российским российском 
судьба: судьба 
замораживать: замороженных 
предлагать: предлагают 
брокер: брокеры 
минфин: минфин 
данный: данным 
физический: физических 
лицо: лиц 
достигать: достигает 
нерезидент: нерезидентов 
занимать: занимали 
противоположный: противоположные 
позиция: позиции 
рухнуть: рухнула 
практически: практически 
ноль: нуля 
источник: источник 
обзор: обзор 
ключевой: ключевых 
показатель: показателей 
профессиональный: профессиональных 
участник: участникам участников 
стр: стр 
гораздо: гораздо 
просто: проще 
низколиквидный: низколиквидными низколиквидных 
создавать: создают 
ажиотаж: ажиотаж 
среди: среди 
зарабатывать: зарабатывает зарабатывают 
рост: росте рост 
площадка: площадкой площадки 
служить: служат 
профильный: профильные 
подписчик: подписчиков 
читатель: читателей 
стимулировать: стимулируют 
активно: активно 
сегодня: сегодня 
влияние: влияние 
сообщение: сообщений 
поведение: поведение 
большой: велико 
недавний: недавним 
исследование: исследованием 
аналитик: аналитики 
позволять: позволяет 
мошенник: мошенникам 
продавать: продать 
свой: свой 
пакет: пакет 
пик: пике 
выходить: выйти 
схема: схемы 
рано: раньше 
остальной: остальных 
солидный: солидной 
прибыль: прибылью 
итог: итоге 
поучительный: поучительна 
неопытный: неопытных 
наглядный: наглядная 
демонстрация: демонстрация 
риск: рисков риски 
активный: активной 
столь: столь 
стремительный: стремительным 
сколь: сколь 
накануне: накануне 
многие: многие 
потерять: потеряли 
теория: теории 
должный: должна 
отслеживать: отслеживать 
предотвращать: предотвращать 
манипулирование: манипулирование 
редко: редко 
вмешиваться: вмешивается 
процесс: процесс 
строгий: строгий 
арбитраж: арбитраж 
противоречить: противоречит 
интерес: интересам 
поскольку: поскольку 
счет: счет счетах 
увеличение: увеличения 
комиссионный: комиссионных 
доход: доходов 
кроме: кроме 
именно: именно 
действие: действия действиях 
конкретный: конкретных 
спровоцировать: спровоцировать 
возможно: возможно 
своевременный: своевременных 
сильный: сильной 
удаваться: удалось 
избегать: избежать 
напоминать: напомнить 
депозитарный: депозитарных 
расписка: расписок 
никакой: никакой 
гарантия: гарантии 
очередной: очередной 
касаться: касаются 
наш: нашем 
подписываться: подписаться подписывайтесь 
тэг: тэги 
мосбиржа: мосбиржа 
рф: рф 
фотография: фотография 
обложка: обложке 
angi: angi 
istock: istock 
проходить: проходят 
модерация: модерацию 
правило: правилам правила 
понадобиться: понадобились 
справка: справки 
репетитор: репетитор 
полагаться: полагался 
каникулы: каникулы 
платить: платил 
налог: налог налоги 
человек: человеку человек 
инвалидность: инвалидностью 
копить: копить 
покупать: покупать 
балл: баллы 
уведомлять: уведомлять 
белоруссия: белоруссии 
работник: работник 
поставлять: поставлять поставить 
товар: товары 
работодатель: работодателю 
ипать: ип 
молодой: молодой 
хотеть: хочет 
оформлять: оформить 
машина: машину 
какой: какие 
быть: будут 
сотрудничать: сотрудничают 
сосед: соседи 
заливать: залили 
дверной: дверную 
ручка: ручку 
замок: замок 
клей: клеем 
протест: протест 
ремонт: ремонта 
завещание: завещание 
ребенок: дети детей 
муж: мужа 
имущество: имущество 
стоимость: стоимости 
здание: здание 
баланс: баланс 
рассказывать: расскажите 
проблема: проблемы проблеме 
багаж: багажом 
возникать: возникали 
поездка: поездках 
косметичка: косметичка 
уход: уход 
чувствительный: чувствительной 
комбинированный: комбинированной 
кожа: кожей 
акна: акне 
последствие: последствия 
покупатель: покупателя 
продавец: продавец 
вносить: внесет 
сколько: сколько 
вернуть: вернуть 
обучение: обучение 
отрабатывать: отработала 
срок: срок 
целевой: целевому 
договор: договор договору 
процент: проценты 
популярный: популярное 
неделя: неделю 
посылка: посылка 
застревать: застряла 
таможня: таможне 
делать: делать 
стаут: стауты 
гоза: гозе 
ламбик: ламбики 
место: мест 
пить: пить 
крафтовый: крафтовое 
пиво: пиво 
москва: москве 
жить: живет 
бали: бали 
зарплата: зарплатой 
въезд: въезда 
сербия: сербию 
россиянин: россиян 
мнение: мнение 
поколение: поколение 
девяностый: девяностых 
лишний: лишнее 
труд: труда 
хороший: лучшие 
беспроводный: беспроводные 
колонка: колонки 
удачный: удачных 
модель: моделей 
розничный: розничной 
сеть: сети 
поволжье: поволжье 
экономист: экономист 
дежурный: дежурный 
электромонтер: электромонтер 
новосибирск: новосибирске 
несколько: несколько 
тратить: тратила 
классный: классные 
впечатление: впечатления 
apple: apple 
watch: watch 
вакансия: вакансии 
проект: проекте 
контакт: контакты 
политика: политика 
конфиденциальность: конфиденциальности 
пользование: пользования 
сайт: сайтом 
ао: ао 
банк: банк 
лицензия: лицензия 
