отчет: отчет 
дитя: дитя 
квартал: квартал квартале 
год: год лет году года 
финансовый: финансовые 
операционный: операционный операционные операционных 
результат: результатов результаты 
компания: компании компания 
промой: промо 
увеличивать: увеличьте увеличить 
доход: доходы доходов доходам доход 
сообщество: сообществом сообщество 
инвестор: инвестор инвесторов 
это: это 
работать: работает 
учебник: учебник 
сравнятор: сравнятор 
ипотека: ипотека 
кредитный: кредитная кредитных 
история: история 
тест: тесты 
дневник: дневники дневник 
трата: трат 
налоговый: налоговые налоговую налоговый 
вычет: вычет 
написать: написать 
инвестиция: инвестиций инвестиции инвестициями 
бизнес: бизнес бизнеса 
разбор: разборы 
закон: законов 
калькулятор: калькуляторы 
путешествие: путешествия 
медицина: медицина 
здоровье: здоровье 
недвижимость: недвижимость 
подкаста: подкасты 
видео: видео 
смотреть: смотреть 
сервис: сервис сервисы 
расчет: расчеты 
закладка: закладки 
письмо: письма 
оставаться: останется оставайтесь 
деньги: деньгами деньги денег 
поток: потоки 
инвестразбор: инвестразборы 
зафиксировать: зафиксировала 
падение: падение 
мать: мать 
mdmg: mdmg 
р: р 
купить: купить 
партнерство: партнерстве 
тинькофф: тинькофф 
котировка: котировок котировки 
обновляться: обновляются 
минута: минут 
начало: начале 
февраль: февраля 
представлять: представила 
продажа: продажи продаж 
слабый: слабые слабых 
показатель: показателей показателя 
крупный: крупных крупнейшего крупнейших крупная 
сегмент: сегмента сегмент 
основной: основные основную основной 
момент: моменты 
общий: общая общей 
выручка: выручки выручка 
текущий: текущий 
отчетный: отчетный 
период: период 
уменьшаться: уменьшилась 
млрд: млрд 
рубль: рублей 
снижение: снижения 
московский: московский московских 
госпиталь: госпиталях госпиталя госпитали госпиталей 
основный: основного 
москва: москве 
сокращаться: сократилась 
фон: фоне 
ослабление: ослабления 
пандемия: пандемия пандемии 
covid: covid 
регион: регионах регионы 
вырастать: вырасти выросли выросла 
счет: счет счетах 
расширение: расширение расширения 
сеть: сети сетей сеть 
течение: течение 
запускать: запустили запустила 
новый: новые новых 
клинический: клинических 
тюмень: тюмени 
сопоставимый: сопоставимые 
упасть: упала упали 
полный: полного 
закрытие: закрытия 
линия: линий 
баланс: баланс балансе 
сформировываться: сформировалась 
чистый: чистой чистая чистый 
денежный: денежная 
позиция: позиция 
размер: размере 
никита: никита 
компанищенко: компанищенко 
частный: частной частных частный 
профиль: профиль 
автор: автора 
курс: курсе курс 
общаться: общаться 
понимать: понимать 
друг: друг друга 
бесплатный: бесплатный 
бережно: бережно 
окружающий: окружающими 
часто: чаще 
получать: получает получать получили 
желать: желаемое 
изучать: изучить 
один: одна 
медицинский: медицинский медицинских медицинским медицинской медицинского 
федеральный: федерального 
масштаб: масштаба 
существовать: существует 
собственность: собственности 
ультрасовременный: ультрасовременных 
высокотехнологичный: высокотехнологичных 
клиника: клиники клиник клинику клиниках 
мощный: мощными 
диагностический: диагностическими 
терапевтический: терапевтическими 
хирургический: хирургическими 
ресурс: ресурсами 
прибыль: прибыли прибыль 
оказание: оказания 
услуга: услуг услуги 
который: который которые которых которого 
предоставлять: предоставляет 
свой: своей свои своими свой своих 
весь: всей 
россия: россии 
менеджмент: менеджменту менеджмент 
структурировать: структурирует 
два: двумя 
способ: способу способами 
география: география географии 
заработок: заработку заработка 
делить: делит 
столичный: столичный 
региональный: региональная региональные региональный региональной 
первый: первого первую первый 
располагаться: располагается 
объект: объектов объекты 
второй: второй второго 
сильно: сильнее сильно 
отставать: отстает 
учет: учетом 
учреждение: учреждения учреждений 
раз: раза 
продемонстрировать: продемонстрировал 
сильный: сильный сильного 
пойти: пошла 
спад: спад 
столица: столице 
наоборот: наоборот 
увеличиваться: увеличилась 
стабильный: стабильных 
рост: роста рост 
средний: среднего 
чека: чека 
значительно: значительнее 
причина: причины 
индексация: индексация 
цена: цен 
двузначный: двузначного двузначный 
количество: количества 
принимать: принятых 
род: родам родов 
цикл: циклов 
эко: эко 
источник: источник 
принадлежать: принадлежат 
европейский: европейской 
часть: части 
сибирь: сибири 
дальний: дальнем 
восток: востоке 
кроме: кроме 
активно: активно 
развивать: развивает 
собственный: собственной собственную 
лабораторный: лабораторной лабораторную 
md: md 
lab: lab 
открывать: открыла 
отделение: отделения 
тот: те 
тенденция: тенденции 
снижаться: снизилась снизились 
приводить: привели 
то: тому 
помогать: помог 
например: например 
стоимость: стоимость стоимости 
посещение: посещения 
процедура: процедуры 
раскрывать: раскрыл 
долговой: долговую 
нагрузка: нагрузку 
капитальный: капитальные 
затрата: затраты 
отсутствовать: отсутствует 
долг: долг 
больший: большая 
свободный: свободная 
сумма: сумма 
приостановка: приостановки 
экспансия: экспансия экспансии 
замораживать: заморозила 
план: планы 
строительство: строительству строительства 
белгород: белгороде 
липецк: липецке 
последний: последнем последние 
решать: решил решит 
продолжать: продолжить 
реализация: реализацию реализации 
проект: проекте проектов проекта 
рамка: рамках 
планировать: планирует 
расширять: расширить 
кластер: кластер кластером 
подмосковье: подмосковье 
помощь: помощью 
онкологический: онкологического 
центр: центра 
изменение: изменение 
месяц: месяца 
медучреждение: медучреждение медучреждения 
ноябрь: ноябре 
екатеринбург: екатеринбурге 
площадь: площадью 
квадратный: квадратных 
метр: метра 
мощность: мощностью 
гинекологический: гинекологических 
операция: операций 
около: около 
тысяча: тысяч 
прием: приемов 
специалист: специалистов 
суммарный: суммарный 
объем: объем 
составлять: составил составить 
млн: млн 
декабрь: декабря 
третий: третий 
офис: офис 
начинать: начнет начала 
работа: работу 
совместно: совместно 
база: базе 
анализ: анализы 
быть: будут 
обрабатываться: обрабатываться 
среднесрочный: среднесрочной среднесрочных 
перспектива: перспективе 
руководство: руководство 
запланировать: запланировало 
выход: выход 
другой: другие 
российский: российские 
середина: середине 
январь: января 
объявлять: объявила 
запуск: запуске 
новое: нового 
амбулаторный: амбулаторного 
мытищи: мытищи 
предлагать: предлагает 
широкий: широкий 
спектр: спектр 
профильный: профильных 
женщина: женщин 
подготовка: подготовке 
беременность: беременности 
включая: включая 
диагностика: диагностику 
лечение: лечение 
бесплодие: бесплодия 
также: также 
функциональный: функциональную 
ультразвуковой: ультразвуковую 
будущее: будущем 
должно: должно 
пациентопоток: пациентопоток 
группа: группы 
направление: направления 
клиент: клиентов 
акция: акции акциях 
мочь: могут 
драйвер: драйвера 
выплата: выплаты выплату выплата 
дивиденд: дивиденд дивидендов 
временно: временно 
снижать: снизить 
темп: темпы 
высокий: высокой 
неопределенность: неопределенности 
именно: именно 
поэтому: поэтому 
рынок: рынок рынке 
ожидать: ожидает 
ускоренный: ускоренной 
переход: перехода 
полугодовой: полугодовые 
стараться: старалась 
распределять: распределять 
акционер: акционерами 
зарабатывать: заработанной 
мсфо: мсфо 
нарушать: нарушило 
правило: правило правилам правила 
итог: итогам итоге 
полугодие: полугодия 
выплачивать: выплатили 
соответствовать: соответствует 
способный: способен 
коэффициент: коэффициент 
распределение: распределения 
появляться: появилась 
полностью: полностью 
частично: частично 
избавляться: избавиться 
финальный: финальный 
единоразовый: единоразово 
максимум: максимум 
скорректироваться: скорректировались 
дальнейший: дальнейшее 
движение: движение 
многое: многом 
зависеть: зависеть 
следующий: следующей 
дивидендный: дивидендной 
рекомендация: рекомендации 
необходимо: необходимо 
сделать: сделать 
повышенный: повышенную 
хотеть: хочет 
восстанавливать: восстановить 
биржевой: биржевую 
капитализация: капитализацию 
иначе: иначе 
боковой: боковой 
тренд: тренд 
некоторый: некоторое 
время: время 
новость: новости 
касаться: касаются 
наш: нашем 
подписываться: подписывайтесь 
происходить: происходящего 
тэг: тэги 
комментарий: комментарии 
проходить: проходят 
модерация: модерацию 
журнал: журнала 
мошенник: мошенникам 
понадобиться: понадобились 
справка: справки 
репетитор: репетитор 
полагаться: полагался 
каникулы: каникулы 
платить: платил 
налог: налог налоги 
человек: человеку человек 
инвалидность: инвалидностью 
копить: копить 
покупать: покупать 
балл: баллы 
уведомлять: уведомлять 
белоруссия: белоруссии 
работник: работник 
поставлять: поставлять поставить 
товар: товары 
работодатель: работодателю 
ипать: ип 
молодой: молодой 
оформлять: оформить 
машина: машину 
какой: какие 
риск: риски 
сотрудничать: сотрудничают 
иностранный: иностранным 
сосед: соседи 
заливать: залили 
дверной: дверную 
ручка: ручку 
замок: замок 
клей: клеем 
протест: протест 
ремонт: ремонта 
завещание: завещание 
ребенок: дети детей 
муж: мужа 
имущество: имущество 
здание: здание 
рассказывать: расскажите 
проблема: проблемы проблеме 
багаж: багажом 
возникать: возникали 
поездка: поездках 
косметичка: косметичка 
уход: уход 
чувствительный: чувствительной 
комбинированный: комбинированной 
кожа: кожей 
акна: акне 
последствие: последствия 
покупатель: покупателя 
продавец: продавец 
вносить: внесет 
доля: доли 
сколько: сколько 
вернуть: вернуть 
обучение: обучение 
отрабатывать: отработала 
срок: срок 
целевой: целевому 
договор: договор договору 
процент: проценты 
популярный: популярное 
неделя: неделю 
посылка: посылка 
застревать: застряла 
таможня: таможне 
делать: делать 
стаут: стауты 
гоза: гозе 
ламбик: ламбики 
место: мест 
пить: пить 
крафтовый: крафтовое 
пиво: пиво 
жить: живет 
бали: бали 
зарплата: зарплатой 
въезд: въезда 
сербия: сербию 
россиянин: россиян 
мнение: мнение 
поколение: поколение 
девяностый: девяностых 
лишний: лишнее 
труд: труда 
хороший: лучшие 
беспроводный: беспроводные 
колонка: колонки 
удачный: удачных 
модель: моделей 
директор: директор 
розничный: розничной 
поволжье: поволжье 
экономист: экономист 
дежурный: дежурный 
электромонтер: электромонтер 
новосибирск: новосибирске 
несколько: несколько 
тратить: тратила 
классный: классные 
впечатление: впечатления 
apple: apple 
watch: watch 
вакансия: вакансии 
сообщать: сообщить 
контакт: контакты 
политика: политика 
конфиденциальность: конфиденциальности 
пользование: пользования 
сайт: сайтом 
выходить: выйти 
ао: ао 
банк: банк 
лицензия: лицензия 
