бизнес: бизнесу бизнес бизнеса 
новость: новости 
статья: статьи 
разбор: разборы 
закон: законов 
инструкция: инструкции 
совет: советы 
учебник: учебник 
сравнятор: сравнятор 
сообщество: сообщество 
ипотека: ипотека 
кредитный: кредитная 
история: история 
тест: тесты 
дневник: дневники дневник 
трата: трат 
налоговый: налоговая налоговый 
вычет: вычет 
написать: написать 
инвестиция: инвестиции 
калькулятор: калькуляторы 
путешествие: путешествия 
медицина: медицина 
здоровье: здоровье 
недвижимость: недвижимость 
подкаста: подкасты 
видео: видео 
смотреть: смотреть 
сервис: сервисы 
расчет: расчеты 
закладка: закладки 
письмо: письма 
оставаться: оставайтесь 
деньги: деньгами 
поток: потоки 
полезный: полезное 
свежий: свежие 
кейс: кейсы 
другой: других 
предприниматель: предпринимателям предпринимателей 
юрист: юристов 
настраивать: настроить 
работа: работу 
онлайн: онлайн 
офлайн: офлайн 
ксения: ксения 
лурье: лурье 
идти: идти 
компромисс: компромисс 
бояться: бояться 
сказать: сказать 
весть: вести 
переговоры: переговоры 
надежда: надежда 
шорохов: шорохова 
делать: делать 
самозанимать: самозанятый 
иностранец: иностранец 
оказывать: оказывать 
услуга: услуги 
регион: регионе 
проживание: проживания 
варя: варя 
гурова: гурова 
невозможно: невозможно 
решать: решила 
закрывать: закрыть 
свое: свое 
производство: производство 
одежда: одежды 
россия: россии 
почитать: почитать 
открывать: открыл открыла открыли 
мнение: мнения мнение 
стас: стас 
хрусталев: хрусталев 
человек: людей 
страшно: страшно 
сотрудник: сотрудников сотруднику сотрудник 
дисциплинировать: дисциплинирует 
устраивать: устроена 
студия: студия 
дизайн: дизайна дизайн 
дмитрий: дмитрий 
кузьмин: кузьмин 
оформлять: оформить 
декретный: декретный 
отпуск: отпуск 
редакция: редакция 
дискуссия: дискуссии 
стоять: стоит 
сокращать: сокращать 
персонал: персонал 
сэкономить: сэкономить 
олеся: олеся 
огурцов: огурцова 
сайт: сайта сайтов сайтом 
поиск: поиска 
разный: разных 
отрасль: отраслей 
никакой: никакой 
становиться: станет 
успешный: успешным 
постоянный: постоянного 
контроль: контроля 
владелец: владельца 
варвара: варвара 
кириллина: кириллина 
музыкант: музыкант 
школа: школу 
сноубординг: сноубординга 
потратить: потратив 
рубль: рублей рубля 
запуск: запуск 
алексей: алексей 
каблучок: каблучков 
врач: врачу 
легально: легально 
консультировать: консультировать 
интернет: интернете 
мясной: мясных 
продукт: продуктов 
маркетплейс: маркетплейсы 
выгодно: выгодно 
покупать: покупать 
мелкий: мелким 
опт: оптом 
сергей: сергей 
антонов: антонов 
статистика: статистика 
среднестатистический: среднестатистический 
бизнесмен: бизнесмен 
лиана: лиана 
липановый: липанова 
экологический: экологические 
акция: акции 
выглядеть: выглядят 
нелепо: нелепо 
интервью: интервью 
леонид: леонидом 
синицын: синицыным 
тимофей: тимофей 
разов: разов 
читатель: читатели 
большой: большой 
холодный: холодный 
который: которые которых 
тысяча: тысяч 
финансовый: финансовое 
чутье: чутье 
угадывать: угадайте 
сколько: сколько 
готовый: готовый 
устаревать: устаревший 
накрутка: накрутка 
посетитель: посетителей 
частый: частых 
ошибка: ошибок 
seo: seo 
марина: марина 
суховский: суховская 
ждать: ждет 
февраль: феврале 
евгений: евгений 
федякин: федякин 
начинать: начинающим 
поздно: поздно 
заходить: заходить 
артем: артем 
мазан: мазанов 
должный: должен 
зарегистрировать: зарегистрировать 
корпоративный: корпоративные 
симкарта: симкарты 
март: марта 
елена: елена 
растворов: растворова 
просто: просто 
увлекать: увлеченная 
мама: мама 
спортсмен: спортсмена 
скалодром: скалодром 
киров: кирове 
послушать: послушать 
подкастовый: подкастов 
взять: взять 
авто: авто 
аренда: аренду 
сдавать: сдавать 
анастасия: анастасия 
корнилов: корнилова 
получать: получит 
рассрочка: рассрочку 
уплата: уплате 
страховой: страховых 
взнос: взносов 
светлана: светлана 
пугач: пугач 
причина: причин 
отказывать: откажет 
регистрация: регистрации 
ипать: ип 
вакансия: вакансии 
сообщать: сообщить 
проблема: проблеме 
проект: проекте 
контакт: контакты 
политика: политика 
конфиденциальность: конфиденциальности 
правило: правила 
пользование: пользования 
выходить: выйти 
ао: ао 
банк: банк 
лицензия: лицензия 
