медицина: медицина 
здоровье: здоровье здоровья 
учебник: учебник 
сравнятор: сравнятор 
сообщество: сообщество 
ипотека: ипотека 
кредитный: кредитная 
история: история истории 
тест: тесты 
дневник: дневники дневник 
трата: трат 
налоговый: налоговый 
вычет: вычет 
написать: написать 
инвестиция: инвестиции 
бизнес: бизнес 
разбор: разборы 
закон: законов 
калькулятор: калькуляторы 
путешествие: путешествия 
недвижимость: недвижимость 
подкаста: подкаста подкасты 
видео: видео 
смотреть: смотреть 
сервис: сервисы 
расчет: расчеты 
закладка: закладки 
письмо: письма 
оставаться: оставайтесь 
деньги: деньгами 
поток: потоки 
выяснять: выясняем 
сэкономить: сэкономить 
дело: дело 
доходить: доходит 
врач: врачей врача 
лекарство: лекарств 
также: также 
пытаться: пытаемся 
весть: вести 
здоровый: здоровый 
образ: образ 
жизнь: жизни 
виктория: виктория 
зорина: зорина 
хороший: лучших лучшие 
раствор: растворы 
контактный: контактных 
линза: линз 
екатерина: екатерина 
герасимова: герасимова 
важный: важные важном 
миф: мифов 
человек: людях 
врожденный: врожденной 
хрупкость: хрупкостью 
кость: костей 
natalia: natalia 
praskova: praskova 
брекет: брекеты 
читатель: читателей 
поставлять: поставила 
один: одного 
продолжать: продолжаю 
лечение: лечения лечении лечение 
другой: другого 
переезд: переезда 
почитать: почитать 
ребенок: дети ребенку ребенка 
экология: экология 
даниил: даниил 
давыдов: давыдов 
проверка: проверка 
слух: слуха 
правда: правда 
ферментировать: ферментированные 
продукт: продукты 
очень: очень 
полезный: полезны полезен 
кадерль: кадерлем 
косметичка: косметичка 
уход: уход 
комбинированный: комбинированной 
кожа: кожей 
лицо: лица 
тело: теле тела 
волос: волос волосами 
год: лет 
анна: анна 
трушин: трушина 
такой: такое 
псориаз: псориаз 
лечить: лечить 
рассказывать: рассказывает расскажите 
дерматолог: дерматолог 
ксения: ксения 
петров: петрова 
выбирать: выбрать 
ортопедический: ортопедическую 
подушка: подушку 
кушнир: кушнир 
вопрос: вопросы 
доктор: доктору 
связанный: связана 
тревога: тревогой 
вызывать: вызывает 
рак: рак раке 
гастроэнтеролог: гастроэнтеролог 
изжога: изжоге 
настя: настя 
ганошенкова: ганошенкова 
придача: придачу 
сломаться: сломалось 
левый: левое 
бедро: бедро 
жить: живу 
несовершенный: несовершенным 
остеогенез: остеогенезом 
ира: ира 
спасюк: спасюк 
способ: способов 
который: которые 
помогать: помогают помогут 
артем: артем 
соколов: соколов 
гейнер: гейнеры 
набор: набора 
мышечный: мышечной 
масса: массы 
делать: делать 
соя: соя 
влиять: влияет 
дарья: дарья 
семеин: семеина 
защищаться: защититься 
клещ: клещей 
медредакция: медредакция 
дискуссия: дискуссии 
сдавать: сдаете 
кровь: кровь 
плохой: худших 
донорский: донорских 
пункт: пунктах 
доводиться: довелось 
побывать: побывать 
ольга: ольга 
титкова: титкова 
нужно: нужно 
удалять: удалять 
аденоиды: аденоиды 
юлия: юлия 
коняхина: коняхина 
зависеть: зависит 
опыт: опыта 
наглость: наглости 
мастер: мастера 
сколько: сколько 
обходиться: обходится 
удаление: удаление 
mr: mr 
wolf: wolf 
чувствительный: чувствительной 
акна: акне 
месяц: месяц 
александра: александра 
шкарина: шкарина 
выпуск: выпусков 
говорить: говорят 
чай: чай 
пуэр: пуэр 
лада: лада 
кошман: кошман 
образование: образование 
последний: последний 
курс: курс 
отдавать: отдал 
учиться: учатся 
стоматолог: стоматологи 
темный: темная 
тема: тема 
браузер: браузерах 
приложение: приложений приложениях 
безопасный: безопаснее 
зрение: зрения 
важно: важно 
знать: знать 
гипертонический: гипертонической 
болезнь: болезни 
большаков: большакова 
бесплатный: бесплатных 
забота: заботы 
олеся: олеся 
огурцов: огурцова 
правильно: правильно 
купать: купать 
диета: диеты 
физиотерапия: физиотерапия 
ревматолог: ревматологу 
ревматоидный: ревматоидном 
артрит: артрите 
вакансия: вакансии 
сообщать: сообщить 
проблема: проблеме 
проект: проекте 
контакт: контакты 
политика: политика 
конфиденциальность: конфиденциальности 
правило: правила 
пользование: пользования 
сайт: сайтом 
выходить: выйти 
ао: ао 
банк: банк 
лицензия: лицензия 
