обзор: обзоры 
закон: закон законов 
разбор: разборы 
нормативный: нормативных 
акт: актов 
законодательный: законодательных 
нововведение: нововведениях нововведений 
совет: советы 
юрист: юристов 
учебник: учебник 
сравнятор: сравнятор 
сообщество: сообщество 
ипотека: ипотека ипотеки 
кредитный: кредитные кредитная 
история: история 
тест: тесты 
дневник: дневники дневник 
трата: трат 
налоговый: налоговая налоговый 
вычет: вычет вычеты 
написать: написать 
инвестиция: инвестиции 
бизнес: бизнес бизнеса 
калькулятор: калькуляторы 
путешествие: путешествия 
медицина: медицина 
здоровье: здоровье 
недвижимость: недвижимость 
подкаста: подкасты 
видео: видео 
смотреть: смотреть 
сервис: сервисы 
расчет: расчеты 
закладка: закладки 
письмо: письма 
оставаться: оставайтесь 
деньги: деньгами денег 
поток: потоки 
рассказывать: рассказываем 
который: которые 
касаться: касаются 
выплата: выплаты выплат 
льгота: льгот льготы 
налог: налоги налогов 
штраф: штрафов штрафы 
подобный: подобного 
екатерина: екатерина 
мирошкин: мирошкина 
дайджест: дайджест 
пособие: пособие пособия 
жилье: жилье 
изменяться: изменится изменятся 
февраль: феврале 
год: лет году года 
новый: новые 
условие: условия 
сотрудник: сотрудники сотрудников 
саша: саша 
кириллов: кириллова 
мочь: могут 
подавать: подать 
заявка: заявки 
отсрочка: отсрочка отсрочку 
армия: армии 
это: это 
сделать: сделать 
почитать: почитать 
суд: суд суды 
теория: теория 
практика: практика 
ваш: ваши 
право: права 
должный: должны 
полина: полина 
калмыков: калмыкова 
ребенок: дети детей 
мобилизация: мобилизацию мобилизации мобилизация 
отцов: отцов 
трое: троих 
отменять: отменили 
пообещать: пообещали 
вернуть: вернуть 
известно: известно 
пенсия: пенсии 
январь: январе 
какой: какие какими 
быть: будут 
мрот: мрот 
прожиточный: прожиточный 
минимум: минимум 
программа: программы 
льготный: льготной 
анастасия: анастасия 
корнилов: корнилов корнилова 
дача: дачи 
загородный: загородные 
дома: дома 
отзывать: отозвать 
разрешение: разрешение 
ввод: ввод 
эксплуатация: эксплуатацию 
дом: дом 
зарегистрировать: зарегистрирован 
сказать: сказал 
кс: кс 
рф: рф 
артем: артем 
мазан: мазанов 
россия: россии 
принимать: приняли 
запрет: запрете 
оштрафовать: оштрафовать 
новое: новое 
единый: единое 
основной: основные 
жкх: жкх 
иноагент: иноагенты 
декабрь: декабре 
новость: новости 
образование: образования 
организация: организациям 
разрешать: разрешили 
расторгать: расторгать 
договор: договоры 
низкий: низкой 
успеваемость: успеваемости 
андрей: андрей 
аренда: аренда 
покупка: покупка покупок 
продажа: продажа 
разъяснять: разъяснила 
продавать: продавать 
регион: регионах 
сокращенный: сокращенным 
срок: сроком 
владение: владения 
президент: президент 
объявлять: объявил 
завершение: завершении 
указ: указа 
кредит: кредиты 
ноябрь: ноябре 
работать: работает 
бронь: бронь 
призыв: призыва 
лиана: лиана 
липановый: липанова 
компания: компании 
малый: малого 
средний: среднего 
получать: получить получат 
каникулы: каникулы 
владелец: владельца 
отец: отцы 
подтверждать: подтвердил 
урал: урале 
списание: списание 
долгов: долгов 
мобилизовать: мобилизовать мобилизованным 
взять: взять 
кто: кого 
родитель: родителей 
ответ: ответы 
сложный: сложные 
вопрос: вопросы 
лимит: лимит 
беспошлинный: беспошлинного 
ввоз: ввоза 
граница: границы 
продлять: продлили 
апрель: апреля 
госуслуга: госуслугах 
обжаловать: обжаловать 
повестка: повестку 
документ: документы 
нужный: нужны 
октябрь: октябре 
ита: ит 
дмитрий: дмитрий 
сергеев: сергеев 
наказывать: наказывать 
преступление: преступления 
период: период 
ведение: ведения 
боевой: боевых 
действие: действий 
вакансия: вакансии 
сообщать: сообщить 
проблема: проблеме 
проект: проекте 
контакт: контакты 
политика: политика 
конфиденциальность: конфиденциальности 
правило: правила 
пользование: пользования 
сайт: сайтом 
выходить: выйти 
ао: ао 
банк: банк 
лицензия: лицензия 
