отчет: отчета отчетов отчет 
ммк: ммк 
год: год годы году лет года 
операционный: операционную операционные 
результат: результаты результате 
компания: компании компания компаний 
промой: промо 
увеличивать: увеличьте 
доход: доходы доход 
сообщество: сообществом сообщество 
инвестор: инвестор инвесторов 
это: это 
работать: работает 
учебник: учебник 
сравнятор: сравнятор 
ипотека: ипотека 
кредитный: кредитная 
история: история 
тест: тесты 
дневник: дневники дневник 
трата: трат 
налоговый: налоговые налоговую налоговый налоговой 
вычет: вычет 
написать: написать 
инвестиция: инвестиции инвестициях инвестициями 
бизнес: бизнес бизнеса 
разбор: разборы 
закон: законов 
калькулятор: калькуляторы 
путешествие: путешествия 
медицина: медицина 
здоровье: здоровье 
недвижимость: недвижимость 
подкаста: подкасты 
видео: видео 
смотреть: смотреть 
сервис: сервис сервисы 
расчет: расчеты 
закладка: закладки 
письмо: письма 
оставаться: останется остается оставайтесь 
деньги: деньгами деньги денег 
поток: потоки 
инвестразбор: инвестразборы 
экспорт: экспорта экспорт 
обвалиться: обвалились обвалился 
внутренний: внутреннем внутренний 
спрос: спроса спрос спросе 
устаивать: устоял 
магнитогорский: магнитогорский 
металлургический: металлургический 
комбинат: комбинат 
magn: magn 
р: р 
купить: купить 
партнерство: партнерстве 
тинькофф: тинькофф 
котировка: котировок котировки 
обновляться: обновляются 
минута: минут 
лидер: лидеров 
российский: российской российских 
черный: черной 
металлургия: металлургии 
входить: входит 
число: числе число 
крупный: крупнейшие крупнейших 
мировой: мировой мировых 
производитель: производителей 
становиться: становится стали стал 
актив: активы 
располагать: расположены 
россия: россии 
турция: турции 
февраль: феврале 
объявлять: объявила 
квартал: квартал квартале 
целое: целом 
оказываться: оказался 
непростой: непростым 
подпадать: подпала 
санкция: санкций санкции 
сталкиваться: столкнулась 
рост: росту ростом рост 
нагрузка: нагрузку нагрузки 
потерять: потеряли потеряла 
кроме: кроме 
прочий: прочего 
укрепление: укрепления 
рубль: рубля 
сказываться: сказался сказалось 
замедление: замедление замедления 
экономический: экономической 
активность: активности 
внешний: внешних внешние 
рынок: рынок рынков рынках рынке рынка 
удаваться: удалось 
частично: частично 
нивелировать: нивелировать 
ущерб: ущерб 
поскольку: поскольку 
консолидировать: консолидированную 
финансовый: финансовых финансового финансовую 
отчетность: отчетность 
раскрывать: раскрывает 
производственный: производственные производственный 
пока: пока 
главный: главным 
источник: источник источником 
информация: информации 
собирать: собрали 
самый: самой самое самым самыми 
важный: важное 
итог: итогам итоге 
понимать: понять 
проходить: проходит проходят 
кризис: кризис 
производство: производством производстве производство производства 
снижаться: снизился снизились снизилось 
неблагоприятный: неблагоприятной 
конъюнктура: конъюнктуры 
экспортный: экспортный экспортными экспортные экспортных 
ремонт: ремонтом ремонта ремонте 
также: также 
фон: фоне 
высокий: высокими высокой 
база: базы 
выплавка: выплавка выплавки 
чугун: чугуна 
сокращаться: сократились сократилась 
схожий: схожим 
причина: причинам причины 
угольный: угольного 
концентрат: концентрата 
увеличиваться: увеличилось 
благодаря: благодаря 
потребность: потребности 
марка: марках 
коксующийся: коксующихся 
уголь: углей 
продажа: продажи продаж продажами 
товарный: товарной 
металлопродукция: металлопродукции 
упасть: упали 
вырастать: вырос выросли выросла 
капитальный: капитальным капитальном капитального 
оборудование: оборудования 
деловой: деловой 
зарубежный: зарубежных 
вячеслав: вячеслав 
макаренко: макаренко 
частный: частный 
профиль: профиль 
автор: автора 
делать: делать 
хороший: лучшую лучшие лучшее 
неделя: неделю 
ваш: вашей 
почта: почте 
каждый: каждый 
понедельник: понедельник 
бесплатно: бесплатно 
подписываться: подписаться подписывайтесь 
завод: завод заводах 
турецкий: турецкий турецкого 
сегмент: сегменте сегмента сегмент 
показывать: показали показал 
раз: раза 
учет: учетом 
доля: доля доли 
выпуск: выпуска выпуске выпуском 
небольшой: невелика 
общий: общее общем 
существенно: существенно 
млн: млн 
тонна: тонн 
объем: объеме объем объемы 
связанный: связано 
продолжительный: продолжительным 
доменный: доменном доменное 
ухудшение: ухудшением 
рыночный: рыночных рыночной 
низкий: низким 
последний: последнее последние 
стараться: старается 
замещать: заместили заместить 
поставка: поставки поставок 
собственный: собственным 
единственный: единственный 
который: который которые которой которая которое 
показатель: показатели показателей 
динамика: динамика динамики динамику 
тысяча: тысяч 
изменение: изменение 
железорудный: железорудного 
сырье: сырья 
составлять: составить составила составили 
предыдущий: предыдущему 
тот: те 
ограничение: ограничений ограничениями ограничения 
ремонтный: ремонтные 
работа: работу работы 
рубеж: рубеж рубежом 
основное: основном 
холдинг: холдинг 
продавать: продает 
листовой: листовой листового 
сортовой: сортового сортовой 
оцинковывать: оцинкованного оцинкованный 
прокат: прокат проката 
премиальный: премиальном премиальной 
продукция: продукция продукцию продукции 
повлиять: повлияло 
снижение: снижение 
падение: падения падение 
сторона: стороны 
автомобильный: автомобильной 
отрасль: отрасли отрасль 
несмотря: несмотря 
реализация: реализации 
портфель: портфеле 
сильно: сильнее 
сляб: слябов 
заготовка: заготовок 
метизный: метизной 
скоро: скорее 
усиление: усилением 
конкуренция: конкуренции 
труба: труб 
толстой: толстого 
стан: стана 
включая: включая 
снг: снг 
вдвое: вдвое 
вид: видам 
горячекатаный: горячекатаный 
добавлять: добавленной 
стоимость: стоимостью стоимости 
номенклатурный: номенклатурные 
позиция: позиции 
толстый: толстый 
лист: лист 
холоднокатаный: холоднокатаный 
полимерный: полимерным 
покрытие: покрытием 
прогноз: прогнозы 
позитивный: позитивные позитивных 
новость: новости новостей 
один: одним 
фактор: факторов 
быть: будут 
влиять: влиять 
необходимость: необходимость 
предприятие: предприятий 
будущее: будущем 
должный: должна должен 
повышать: повысить 
эффективность: эффективность 
ограничивать: ограничить 
возможность: возможности 
отремонтировать: отремонтирует 
конвертерный: конвертерное 
магнитогорск: магнитогорске 
продолжаться: продолжится 
строительство: строительство 
коксовый: коксовой 
батарея: батареи 
снижать: снизили снизить 
экологический: экологическую 
ожидать: ожидаемо ожидает 
стабильный: стабильных 
руководство: руководство 
рассчитывать: рассчитывает 
устойчивый: устойчивый 
страна: страны странах 
ближний: ближнего 
зарубежье: зарубежья 
ждать: ждет 
положительный: положительных положительной 
совокупность: совокупности 
должно: должно 
компенсировать: компенсировать 
сырьевой: сырьевых 
затрата: затрат 
влияние: влияние 
стоять: стоит 
упоминать: упомянуть 
ряд: ряд 
опубликовывать: опубликовала 
время: время 
пострадать: пострадал пострадавший 
серия: серии 
землетрясение: землетрясений 
важно: важно 
ощутимо: ощутимо 
расти: растет 
прошлое: прошлого 
около: около 
полугодие: полугодии 
сохранять: сохранил 
лидерство: лидерство 
плоский: плоского 
металлопрокат: металлопроката 
среди: среди 
успешно: успешно 
размещать: разместил 
облигация: облигации 
доллар: долларов 
значительный: значительную 
часть: часть 
гарантированный: гарантированных 
еврооблигация: еврооблигаций 
выпускать: выпущенных 
ранее: ранее 
mmk: mmk 
international: international 
capital: capital 
называть: назвать 
слабый: слабыми 
основной: основные основных 
направление: направления 
существенный: существенный существенное 
спад: спад 
большой: наибольший 
удар: удар 
приходиться: пришелся 
момент: моментов 
отмечать: отметить 
отчасти: отчасти 
помогать: помог 
выделяться: выделяется 
замещение: замещения 
сторонний: сторонних 
оценка: оценки 
перспектива: перспектив 
больший: большей 
степень: степени 
ориентировать: ориентирована 
обращать: обратить 
внимание: внимание 
строительный: строительной строительную строительного 
наряду: наряду 
впк: впк 
потребитель: потребителей 
металл: металла 
зафиксировать: зафиксирован 
рекорд: рекорд 
ввод: ввода 
эксплуатация: эксплуатацию 
жилье: жилья 
начинать: начиная 
сентябрь: сентября 
отмечаться: отмечается 
темп: темпов 
драйвер: драйверов 
выступать: выступает 
льготный: льготная 
действие: действие 
продлять: продлили 
правда: правда 
плохой: худших 
условие: условиях 
банк: банк банки 
выдача: выдачу 
ипотечный: ипотечных 
кредит: кредитов 
стимулировать: стимулировать 
сложно: сложнее 
сберегательный: сберегательной 
модель: модели моделей 
поведение: поведения 
придерживаться: придерживаются 
россиянин: россияне россиян 
потенциал: потенциал 
зависеть: зависеть 
состояние: состояния 
экономика: экономики 
способность: способности 
китай: китая 
восстанавливаться: восстановиться 
локдаун: локдаунов 
западный: западные 
справляться: справляться 
риск: риски рисками 
рецессия: рецессии 
акция: акции 
октябрь: октября 
наблюдаться: наблюдается 
восстановление: восстановление 
цена: цен 
сталь: сталь 
ослабление: ослаблением 
неопределенность: неопределенность 
будущий: будущим 
бумага: бумаг 
сохраняться: сохраняется 
публикация: публикаций 
ясность: ясности 
относительно: относительно 
tradingview: tradingview 
касаться: касаются 
наш: нашем 
курс: курсе 
происходить: происходящего 
тэг: тэги 
комментарий: комментарии 
модерация: модерацию 
правило: правилам правила 
журнал: журнала 
мошенник: мошенникам 
понадобиться: понадобились 
справка: справки 
репетитор: репетитор 
полагаться: полагался 
каникулы: каникулы 
платить: платил 
налог: налог налоги 
человек: человеку человек 
инвалидность: инвалидностью 
копить: копить 
покупать: покупать 
балл: баллы 
уведомлять: уведомлять 
счет: счет счетах 
белоруссия: белоруссии 
работник: работник 
поставлять: поставлять поставить 
товар: товары 
работодатель: работодателю 
ипать: ип 
молодой: молодой 
хотеть: хочет 
оформлять: оформить 
машина: машину 
какой: какие 
сотрудничать: сотрудничают 
иностранный: иностранным 
сосед: соседи 
заливать: залили 
дверной: дверную 
ручка: ручку 
замок: замок 
клей: клеем 
протест: протест 
завещание: завещание 
ребенок: дети детей 
муж: мужа 
получать: получать получили 
имущество: имущество 
здание: здание 
баланс: баланс 
рассказывать: расскажите 
проблема: проблемы проблеме 
багаж: багажом 
возникать: возникали 
поездка: поездках 
косметичка: косметичка 
уход: уход 
чувствительный: чувствительной 
комбинированный: комбинированной 
кожа: кожей 
акна: акне 
последствие: последствия 
покупатель: покупателя 
продавец: продавец 
вносить: внесет 
сколько: сколько 
вернуть: вернуть 
обучение: обучение 
отрабатывать: отработала 
срок: срок 
целевой: целевому 
договор: договор договору 
процент: проценты 
популярный: популярное 
посылка: посылка 
застревать: застряла 
таможня: таможне 
стаут: стауты 
гоза: гозе 
ламбик: ламбики 
место: мест 
пить: пить 
крафтовый: крафтовое 
пиво: пиво 
москва: москве 
жить: живет 
бали: бали 
зарплата: зарплатой 
въезд: въезда 
сербия: сербию 
мнение: мнение 
поколение: поколение 
девяностый: девяностых 
лишний: лишнее 
труд: труда 
беспроводный: беспроводные 
колонка: колонки 
удачный: удачных 
директор: директор 
розничный: розничной 
сеть: сети 
поволжье: поволжье 
экономист: экономист 
дежурный: дежурный 
электромонтер: электромонтер 
новосибирск: новосибирске 
несколько: несколько 
тратить: тратила 
классный: классные 
впечатление: впечатления 
apple: apple 
watch: watch 
вакансия: вакансии 
сообщать: сообщить 
проект: проекте 
контакт: контакты 
политика: политика 
конфиденциальность: конфиденциальности 
пользование: пользования 
сайт: сайтом 
выходить: выйти 
ао: ао 
лицензия: лицензия 
