косметичка: косметичка 
уход: уход ухода уходу 
чувствительный: чувствительной 
комбинированный: комбинированной комбинированная 
кожа: коже кожей кожа кожи 
акна: акне 
промой: промо 
заклинание: заклинание 
бесплатный: бесплатную 
кредитка: кредитку 
fgo: fgo 
заказывать: заказать 
карта: карту 
учебник: учебник 
сравнятор: сравнятор 
сообщество: сообществе сообщество 
ипотека: ипотека 
кредитный: кредитная 
история: историю история 
тест: тесты 
дневник: дневники дневник 
трата: трат 
налоговый: налоговые налоговую налоговый 
вычет: вычет 
написать: написать написано написали написан 
инвестиция: инвестиции 
бизнес: бизнес бизнеса 
разбор: разборы 
закон: законов 
калькулятор: калькуляторы 
путешествие: путешествия 
медицина: медицина 
здоровье: здоровье 
недвижимость: недвижимость 
подкаста: подкасты 
видео: видео 
смотреть: смотреть 
сервис: сервисы 
расчет: расчеты 
закладка: закладки 
письмо: письма 
оставаться: оставайтесь 
деньги: деньгами деньги денег 
поток: потоки 
текст: текст 
немой: нем 
сохранять: сохранены 
авторский: авторский 
стиль: стиль 
орфография: орфография 
сейлор: сейлор 
марс: марс 
профиль: профиль 
автор: автора 
год: год лет году года 
жирный: жирная 
карточка: карточке 
дело: деле 
блестеть: блестит 
похожий: похожа 
нормальный: нормальную нормальная 
внешне: внешне 
идеальный: идеальная идеальной 
организм: организм 
давать: дал 
сбой: сбой 
болячка: болячки 
обнаруживать: обнаружены 
вылечивать: вылечены вылечить 
остальной: остальной 
половина: половиной 
работать: работаю 
кажется: кажется 
мой: мои моей 
воспаление: воспалениями воспалений воспаления 
выглядеть: выглядят 
незначительно: незначительно 
косметолог: косметологу косметолог косметологи 
дерматолог: дерматологи дерматолог дерматологу дерматолога 
сильно: сильно 
придавать: придавали 
это: этому это 
значение: значения 
спустя: спустя 
скитание: скитаний 
находить: нашла нашли 
свой: своё своего 
врач: врача врачом 
подбирать: подбирала подобрала подобранные 
никак: никак 
хороший: хорошей лучшие хорошему 
позволять: позволяла 
умываться: умылась умываться умываюсь 
мыло: мылом 
пользоваться: пользоваться 
крем: крем кремом 
зимний: зимнее 
время: время 
пойти: пошла 
впервые: впервые 
сделать: сделала сделать 
чистка: чистки чистку чистками 
отправлять: отправила 
анализ: анализам анализы анализах 
сдавать: сдала 
кровь: кровь 
тд: тд 
идеально: идеально 
посоветовать: посоветовала 
серия: серию серии серия 
la: la 
effaclar: effaclar 
обещать: обещала 
легкое: легкие 
улучшение: улучшения 
уходить: ушла ушло 
конец: конца 
который: которая которыми 
хотеть: хотела хочет хочу 
пилинг: пилинги пилинг пилингами пилингов 
счастие: счастью 
быстро: быстро 
понимать: поняла 
подходить: подходит 
она: неё её 
успевать: успела 
пострадать: пострадать 
видеть: видела 
проблема: проблем проблемы проблеме 
кормить: кормить 
ретинойд: ретинойдами 
еще: ещё 
тот: та 
советовать: советовала 
рожать: родить 
проходить: проходят прошло 
отчаиваться: отчаялась 
сам: сама 
читать: читая 
блог: блог 
куча: кучу 
отзыв: отзывов отзывах 
средство: средствах средства средств 
примерно: примерно 
прикидывать: прикинула 
обезвоживать: обезвожена 
dr: dr 
ceuracle: ceuracle 
pure: pure 
cleansing: cleansing 
oil: oil 
утро: утром 
массажировать: массажирую 
лицо: лицу лице лицо лица 
точка: точки 
вылетать: вылетают 
вроде: вроде 
рубль: рублей 
creamy: creamy 
foam: foam 
пенка: пенкой пенка 
гидрофилка: гидрофилка гидрофилки 
вечер: вечером 
стоять: стоит 
базирон: базирон 
ас: ас 
точечный: точечно 
bioderma: bioderma 
sebium: sebium 
hydra: hydra 
увлажнять: увлажняет увлажняющий 
limoni: limoni 
snail: snail 
repair: repair 
век: век 
fresh: fresh 
skin: skin 
amazing: amazing 
apple: apple 
facial: facial 
неделя: недели неделю 
aqua: aqua 
sun: sun 
gel: gel 
бепантный: бепантен 
случай: случай 
шелушение: шелушений 
затем: затем 
сходить: сходила 
скорректировать: скорректировали 
причина: причины 
назначать: назначили 
лечение: лечение 
отвечать: ответили ответить 
вопрос: вопросы 
объяснять: объяснили 
сутки: сутки 
голова: голова головы голове 
место: месте мест 
внутрь: внутрь 
быть: будут буду 
писать: писать 
индивидуально: индивидуально 
принимать: принимал 
лекарство: лекарства 
добавка: добавки 
метрогила: метрогил 
гель: гель 
аптека: аптеке аптеки 
eau: eau 
thermale: thermale 
avene: avene 
вода: вода 
термальный: термальная 
курс: курс 
азелаинов: азелаиновых 
домашний: домашний 
убирать: убрали убирает 
скраб: скраб скрабы 
запрет: запретом 
клиника: клинике 
использовать: использую 
муж: мужа муже 
сколько: сколько 
тратить: трачу тратила 
месяц: месяц 
любить: люблю 
аптечный: аптечную 
косметика: косметику косметика 
думать: думаю 
дорогой: дорогая 
впереди: впереди 
целое: целом 
продукт: продукты 
один: одной 
ценовой: ценовой 
категория: категории 
порадовать: порадовало 
давно: давно 
пробовать: пробовала 
всякий: всякие 
eco: eco 
чистый: чистые 
линия: линии 
жемчуг: жемчуга жемчуги 
garnier: garnier 
avon: avon 
безумный: безумное 
отличие: отличие 
проф: проф 
небо: небо 
земля: земля 
сушить: сушит 
стягивать: стягивает 
просто: просто 
бесить: бесит 
помогать: помогает 
самый: самые 
состав: составы 
ужасный: ужасный 
опыт: опыт 
подарить: подарили 
ровно: ровно 
получать: получать получила получили 
ожог: ожог 
венок: венки 
крыло: крыльях 
нос: носа 
предстоять: предстоит 
разбираться: разобраться 
недорогой: недорогих 
волос: волосами волосы волос 
нравиться: нравится 
капус: капус 
находка: находка 
подруга: подруги 
реально: реально 
оздоровлять: оздоровил 
продолжать: продолжает 
радовать: радовать 
длинный: длинные 
густой: густые 
пробор: пробор 
купить: куплю купила купить 
против: против 
выпадение: выпадения 
слышать: слышала 
пушок: пушок 
прямой: прям 
отрастать: отрастает 
человек: людей человеку человек 
пока: пока 
умывание: умывания 
набор: набор 
массаж: массажей массажа массаж 
гуаша: гуаша 
розовый: розового 
кварц: кварца 
начинать: начинаю 
входить: входить 
вкус: вкус 
рука: рук руки 
aravia: aravia 
сахарный: сахарный 
sinichka: sinichka 
kapous: kapous 
масло: масло 
кутикула: кутикулы 
ноготь: ногтей 
milv: milv 
ежедневно: ежедневно 
парафин: парафин 
вместе: вместе 
нога: ноги 
жидкий: жидкий 
педикюр: педикюр 
ультраувлажнять: ультраувлажняющий 
мочевина: мочевиной 
шампунь: шампунь 
лосьон: лосьон 
professional: professional 
fragrance: fragrance 
free: free 
treatmen: treatmen 
все: всё 
бальзам: бальзам 
magic: magic 
keratin: keratin 
маленький: маленький 
маска: маска маски 
studio: studio 
oliva: oliva 
avocado: avocado 
кончик: кончики 
мытье: мытья 
тело: тело тела телом 
сухой: сухой сухие 
щетка: щеткой 
натуральный: натуральная 
банк: банками банк 
ставить: ставлю 
трапеция: трапеции 
уметь: умею 
стекло: стекло 
compliment: compliment 
баттер: баттер 
кокосовый: кокосовый 
ваниль: ванилью 
практически: практически 
покупать: покупать покупала покупаю 
золото: золотом 
яблоко: яблоке 
синичка: синичку 
озон: озон 
spf: spf 
потрясать: потрясающая 
любовь: любовь 
первый: первого 
применение: применения 
витамин: витамины 
читатель: читатели 
рассказывать: рассказывают рассказать расскажите 
разоряться: разориться 
подписываться: подписаться 
тэг: тэги 
комментарий: комментарии 
модерация: модерацию 
правило: правилам правила 
журнал: журнала 
анна: анна 
герой: герой 
спасибо: спасибо 
обзор: обзор 
интересно: интересно 
высыпание: высыпаниями высыпаний 
сказать: сказал 
никакой: никаких никакая 
то: тому 
незаметный: незаметных 
камень: камне 
цеплять: цепляет 
бактерия: бактерии 
разносить: разносит 
дезинфекция: дезинфекция 
пожалуйста: пожалуйста 
разрешать: разрешили 
необходимо: необходимо 
обходить: обходить 
проблемный: проблемные 
зона: зоны 
обо: обо 
предупреждать: предупредили 
грудь: груди 
шея: шее 
аккуратно: аккуратно 
наталия: наталия 
мехедов: мехедова 
понравиться: понравилось 
эффект: эффект 
kаpous: kаpous 
пористый: пористые 
шикарный: шикарный 
смягчать: смягчает 
напитывать: напитывает 
сразу: сразу 
процесс: процессе 
смыв: смыва 
чувствовать: чувствуешь 
разница: разницу 
рано: раньше 
суховатый: суховаты 
кучерявый: кучерявые 
кератин: кератин 
спасать: спасала 
зря: зря 
авокадо: авокадо 
следующий: следующей 
флюид: флюиды 
спрей: спреи 
классно: классно 
мошенник: мошенникам 
понадобиться: понадобились 
справка: справки 
репетитор: репетитор 
полагаться: полагался 
каникулы: каникулы 
платить: платил 
налог: налог налоги 
инвалидность: инвалидностью 
копить: копить 
балл: баллы 
уведомлять: уведомлять 
счет: счет счетах 
белоруссия: белоруссии 
работник: работник 
поставлять: поставлять поставить 
товар: товары 
работодатель: работодателю 
ипать: ип 
молодой: молодой 
оформлять: оформить 
машина: машину 
какой: какие 
риск: риски 
сотрудничать: сотрудничают 
иностранный: иностранным 
сосед: соседи 
заливать: залили 
дверной: дверную 
ручка: ручку 
замок: замок 
клей: клеем 
протест: протест 
ремонт: ремонта 
завещание: завещание 
ребенок: дети детей 
имущество: имущество 
стоимость: стоимости 
здание: здание 
баланс: баланс 
багаж: багажом 
возникать: возникали 
поездка: поездках 
последствие: последствия 
покупатель: покупателя 
продавец: продавец 
вносить: внесет 
доля: доли 
вернуть: вернуть 
обучение: обучение 
отрабатывать: отработала 
срок: срок 
целевой: целевому 
договор: договор договору 
составлять: составить 
процент: проценты 
популярный: популярное 
посылка: посылка 
застревать: застряла 
таможня: таможне 
делать: делать 
стаут: стауты 
гоза: гозе 
ламбик: ламбики 
пить: пить 
крафтовый: крафтовое 
пиво: пиво 
москва: москве 
жить: живет 
бали: бали 
зарплата: зарплатой 
въезд: въезда 
сербия: сербию 
россиянин: россиян 
мнение: мнение 
поколение: поколение 
девяностый: девяностых 
лишний: лишнее 
рынок: рынке 
труд: труда 
беспроводный: беспроводные 
колонка: колонки 
удачный: удачных 
модель: моделей 
директор: директор 
розничный: розничной 
сеть: сети 
поволжье: поволжье 
экономист: экономист 
дежурный: дежурный 
электромонтер: электромонтер 
новосибирск: новосибирске 
несколько: несколько 
классный: классные 
впечатление: впечатления 
watch: watch 
вакансия: вакансии 
сообщать: сообщить 
проект: проекте 
контакт: контакты 
политика: политика 
конфиденциальность: конфиденциальности 
пользование: пользования 
сайт: сайтом 
выходить: выйти 
ао: ао 
лицензия: лицензия 
