философия: философии философией философия 
копить: копить 
деньги: деньги деньгам денег деньгах деньгами 
впечатление: впечатления впечатлениями впечатление впечатлений 
промой: промо 
tinkoff: tinkoff 
platinum: platinum 
лимит: лимитом 
заказывать: заказывали заказать 
карта: картах карту 
учебник: учебник 
сравнятор: сравнятор 
сообщество: сообщество 
ипотека: ипотеку ипотека 
кредитный: кредитная 
история: историями история историям истории 
тест: тесты 
дневник: дневники дневник 
трата: траты трат 
налоговый: налоговые налоговую налоговый 
вычет: вычет 
написать: написать написала 
инвестиция: инвестиции 
бизнес: бизнесов бизнес бизнеса 
разбор: разборы 
закон: законов 
калькулятор: калькуляторы 
путешествие: путешествиях путешествие путешествий путешествия 
медицина: медицина медицине 
здоровье: здоровье здоровья 
недвижимость: недвижимость 
подкаста: подкасты 
видео: видео 
смотреть: смотрели смотрел смотреть 
сервис: сервиса сервис сервисы сервисов 
расчет: расчеты 
закладка: закладки 
письмо: письма 
оставаться: осталось оставайтесь оставалось остался остались 
поток: потоки 
покупка: покупки 
несколько: несколько нескольких 
год: год годы году лет года годах 
тратить: трачу тратила тратили тратить тратим 
классный: классные классного 
вместо: вместо 
doo: doo 
uap: uap 
жить: живу жить живет живите жила жил жили 
профиль: профиль 
автор: автор автора автору авторы авторов 
один: одном одной одна одного одними одним одно одну 
утро: утра утром 
подъезжать: подъезжала 
офис: офисе офису офиса 
поймать: поймала 
мысль: мысль мысли 
мой: моему моих мое моего мои моим моей 
такси: такси 
разбиваться: разбиться разбилось 
настолько: настолько 
хотеться: хотелось хочется 
идти: шли иду идти 
работа: работе работу работы работа работой 
понимать: понимаю понимать понимаете поняла 
далеко: далеко дальше 
момент: момента момент 
руководить: руководила 
московский: московском московской 
фирма: фирме 
учет: учетом 
проект: проекте проект проектов проекты 
зарабатывать: зарабатывает зарабатывали зарабатывала заработанные зарабатывать заработать 
р: р 
месяц: месяца месяц месяцев 
этот: этих эта 
офисный: офисная офисном 
угнетать: угнетала угнетает угнетать 
появляться: появилась появлялись появилось 
свой: своей своими свои свой своя своего своим 
откладывать: откладываю отложить откладывать 
черный: черный 
день: дни день дней 
опыт: опыты опытам опыт опытах 
человек: человеком человека люди людьми людей человеку человек 
происходить: происходящим произошли происходило произойти происходит 
угодно: угодно 
автокатастрофа: автокатастрофа 
уличный: уличная 
драка: драка 
осложнение: осложнения 
болезнь: болезнь болезни 
завтра: завтра 
умирать: умрет умер 
накопление: накопления накоплений 
курс: курсов курса курс 
общаться: общаться общались 
друг: друга друзей друг другом друзья 
бесплатный: бесплатный бесплатных бесплатные 
бережно: бережно 
окружающий: окружающими 
часто: чаще часто 
получать: получаешь получал получить получала получаю получать получила получили 
желать: желаемое 
изучать: изучать изучить изучаю изучила изучала 
увольняться: уволились уволилась 
пробовать: пробовать пробовала 
разный: разные разными разное разных 
способ: способов способы 
работать: работала работает работаем работать работал 
запуск: запуска 
собственный: собственную собственных собственный 
магазин: магазинов 
смм: смм 
фриланс: фрилансе 
новый: новый новые новых новой новую новая 
навык: навыки 
посещение: посещение 
любопытный: любопытный любопытных 
музей: музей музее музеев музеи 
ресторан: ресторанов 
знакомство: знакомства знакомство 
интересный: интересными интересные 
купаться: купалась 
секретный: секретные секретных секретном секретным секретный 
сенота: сеноте 
мексика: мексике мексику 
предложение: предложения предложение 
рука: рук руку руки 
сердце: сердца 
кабо: кабо 
рок: рока 
самый: самые самая самое самом самый самой самых 
западный: западная западной 
точка: точке точка точкой точку 
европа: европе европы 
веселиться: веселилась 
вечеринка: вечеринкой вечеринку вечеринке вечеринки вечеринка 
миллионер: миллионерами миллионеров 
майами: майами 
карабкаться: карабкаются карабкалась 
гора: горам 
забросить: заброшенный 
маяк: маяк маяком 
сахалин: сахалине сахалина сахалину сахалин 
побывать: побывали побывала побывать 
страна: страны стран странах стране 
равно: равно 
мало: мало меньше 
молодой: молодой молодого молодым 
свое: свое 
агентство: агентстве агентства агентство 
создавать: создаю 
сайт: сайте сайтом сайты сайт 
доход: доходов дохода доход 
реклама: реклама рекламы 
жизнь: жизнью жизнь жизнях жизни 
стабильность: стабильности 
купить: купила купили купить купленная 
квартира: квартире квартиры квартиру квартира 
сделать: сделала сделать сделал сделали 
ремонт: ремонт ремонта 
переезжать: переехал переехала 
пыльный: пыльной 
москва: москве москва москву москвы 
зеленый: зеленое 
подмосковье: подмосковье 
переставать: перестать переставала перестала 
рекламный: рекламный рекламных 
объявление: объявлениях 
статья: статье статьи статью статья статьях 
рассказывать: рассказал расскажу расскажите рассказывал 
приходить: приходил прийти пришла 
сколько: сколько 
поделиться: поделюсь поделились 
приключение: приключения приключений приключениях приключение 
дорога: дорога 
дом: дому дом 
который: который которые которых которого которыми котором которым которому 
снимать: снимала снять 
лиссабон: лиссабоне лиссабон лиссабона 
непризнанный: непризнанного 
гениальный: гениального 
художник: художника 
верх: верху 
лестница: лестнице лестницы лестница 
собор: соборе собор 
район: районе районов 
белем: белеме 
удаваться: удалось удается 
бесплатно: бесплатно 
наслаждаться: насладиться 
органный: органной 
музыка: музыки музыкой 
ошеломительный: ошеломительными 
витраж: витражами 
маврикий: маврикии маврикий 
сафари: сафари 
квадрабайка: квадрабайке квадрабайках 
парк: парке 
касесть: касела 
это: этому этим это 
наверное: наверное 
прекрасный: прекрасное прекрасных прекрасны 
зоопарк: зоопарков зоопарках зоопарк зоопарка зоопарке 
зебра: зебры 
жевать: жевали 
яблоко: яблоки 
страус: страусы 
норовить: норовили 
цапнуть: цапнуть 
ухо: ухо 
сад: сад 
дома: дома 
лондон: лондон лондоне 
лиса: лиса 
частый: частым 
гость: гостем гости гостей 
вообще: вообще 
лис: лис 
придумывать: придумали придумала 
название: название названия 
city: city 
fox: fox 
почему: почему 
решать: решил решила решит решили 
покупать: покупать покупаю 
предпосылка: предпосылок 
воспоминание: воспоминания 
порядок: порядку 
скучный: скучной скучное 
детство: детство 
девяностый: девяностых девяностые 
многие: многие 
ютиться: ютились 
тесный: тесных 
квартирка: квартирках 
семья: семьей семью семьи 
отлично: отлично 
мерка: меркам 
тот: те тех 
время: времена время времени времен 
трехэтажный: трехэтажный 
японский: японские японское японской 
машина: машину машины машине 
мама: маме мамы мама 
отчим: отчима 
двор: дворе 
стоять: стояла стоят стоит 
третий: третья 
лишний: лишнее лишняя 
мы: нам 
остров: остров острове 
пригонять: пригоняли 
япония: японии 
родитель: родители 
менять: меняли 
гигантский: гигантские 
собака: собакой собаки 
кавказский: кавказские 
овчарка: овчарки 
щенок: щенками 
впечатлительный: впечатлительного 
ребенок: детям детей дети ребенка 
атрибут: атрибут 
роскошь: роскоши 
держать: держала держали 
ежовый: ежовых 
рукавица: рукавицах 
модный: модной 
одежда: одежды 
рюкзак: рюкзака 
симпатичный: симпатичного 
пенал: пенала 
ездить: ездим ездил ездила ездили 
поход: поход походы 
праздновать: праздновали 
рождение: рождения 
грустно: грустно 
наедаться: наедались 
речь: речь 
президент: президента 
общий: общем 
унылый: унылой 
фраза: фраз 
говорить: говорила говорить говоря 
устраиваться: устроилась устроился устроится 
первый: первых первого первую первый 
течение: течение 
каждый: каждая каждый каждого каждую 
махать: махала 
метла: метлой 
облагораживать: облагораживала 
городской: городские 
сквер: скверы 
точно: точно 
помнить: помню 
зарплата: зарплатой зарплаты зарплату 
получка: получки 
спускать: спустила 
аудиокассета: аудиокассеты 
пять: пять 
жуткий: жутких 
сборник: сборников 
эстрадный: эстрадных 
артист: артистов 
вроде: вроде 
зато: зато 
сей: сих 
пора: пор 
сказочно: сказочно 
чувствовать: чувствовать чувствовала 
благодаря: благодаря 
мочь: могут можешь могу могла мог 
нелюбимый: нелюбимая 
девочка: девочки 
стараться: стараемся стараюсь старалась 
правило: правилам правила 
оканчивать: окончила 
университет: университет 
построить: построила построили 
карьера: карьеру 
специальность: специальности 
сфера: сфере сфер 
пиар: пиара пиаром 
маркетинг: маркетинга маркетинге маркетингу маркетингом 
неплохой: неплохой 
перспективный: перспективной 
вырастать: выросла 
руководитель: руководителя 
подразделение: подразделения 
босс: боссом босс 
отличный: отличные 
отношение: отношения отношение 
позволять: позволяю позволю позволяют позволить 
дорогой: дорогих дорогие дороже 
спонтанный: спонтанные 
например: например 
однажды: однажды 
выходной: выходной выходных 
просто: просто проще 
прогуливаться: прогулялась 
близкий: ближайшего ближайшее 
автосалон: автосалона 
наличный: наличные 
ниссан: ниссан 
альмера: альмера 
полный: полный полным полна 
набор: набором 
доп: допов 
несмотря: несмотря 
ощущать: ощущала 
рабство: рабстве 
выбирать: выбирать выбирали выбирайте выбрали 
должный: должна должны 
находиться: находиться находился 
вечер: вечером вечера 
личный: личная личный личную 
находить: нашла найти нашли находила нахожу нашел 
причина: причину 
постоянный: постоянной 
усталость: усталости 
избавляться: избавилась 
бывший: бывшим бывший 
муж: мужем мужа муж 
примерно: примерно 
период: период 
умудряться: умудрилась 
выходить: выйти 
замуж: замуж 
будущий: будущим будущих 
познакомиться: познакомилась 
отпуск: отпуске 
португалия: португалии 
итог: итоге 
расходиться: разошлись 
брак: брака 
давать: дано дает дал дали дают 
ментальный: ментального 
пинок: пинка 
очень: очень 
легкий: легкий 
подъем: подъем 
мир: мир миру 
рождаться: родился 
италия: италии 
великобритания: великобритании 
бразилия: бразилии 
бояться: боялся 
неопределенность: неопределенности 
лететь: летел летела 
душа: души душа 
звать: звала 
вдохновляться: вдохновилась 
пример: примером примеру пример 
хотеть: хотела хотел хотели хочет хотите хочу 
рассуждать: рассуждал 
коуч: коуча 
тоня: тони 
роббинс: роббинс 
вишня: вишен 
лакьянь: лакьяни 
оба: обе обоих оба 
сомнительный: сомнительные 
гуру: гуру 
прислушиваться: прислушивался 
партнерский: партнерским партнерскому партнерском 
продвигать: продвигаешь 
товар: товары 
услуга: услугой услуги 
комиссия: комиссии комиссию 
продажа: продаж 
слово: слово словам слов 
заходить: заходил 
действовать: действовать 
подумать: подумала подумать 
ведение: ведении 
блог: блогов 
seo: seo 
учиться: училась 
помощь: помощью 
udemy: udemy 
coursera: coursera 
codeacademy: codeacademy 
брать: беру брала брали берем 
любой: любой любом любые 
заказ: заказ заказы 
нравиться: нравились нравится нравятся 
связанный: связаны 
писательство: писательством 
иллюстрация: иллюстрацией 
продолжать: продолжаю 
подряд: подряд 
коллекция: коллекция 
курсы: курсы 
платный: платные 
стоить: стоила стоил стоили стоило 
среднее: среднем 
жажда: жажда 
трудность: трудностей 
нестабильный: нестабильная 
тонус: тонусе 
сложность: сложности 
делать: делаю делать делала делают 
сильно: сильнее сильно 
учить: учат 
адаптироваться: адаптироваться 
становиться: стал стать становится стало стала 
слишком: слишком 
комфортно: комфортно 
развиваться: развиваться 
получаться: получалось получатся получилось получается получится 
то: тому 
путешествовать: путешествовать путешествовала путешествуйте путешествовали путешествую путешествуем путешествует 
видеть: видел видеть видели видишь 
другой: другие других другим 
телевизор: телевизора 
интернет: интернет интернета 
лично: лично 
провожать: проводила 
граница: границу границей 
уезжать: уезжала 
россия: россии 
планировать: планирую планировала 
деятельность: деятельность 
везде: везде 
ита: ит 
совет: совет советов 
помогать: помог помогает помогают помогут 
поездка: поездку поездки поездка поездок поездкой поездке поездках 
совмещать: совмещаю совместить 
отдых: отдыха отдых 
афины: афинах 
нынешний: нынешний 
бойфренд: бойфренд бойфренду бойфрендом бойфренда 
любить: любит люблю любила любим любите 
узнавать: узнавали узнавать узнала узнали узнать 
новое: новое 
съезжаться: съехались 
наш: нашего наших нашей наше наш 
лодка: лодка лодку лодке 
любовь: любви 
скала: скалы 
быт: быта 
поэтому: поэтому 
традиция: традицию традициях 
свидание: свидания свидание свиданий 
среда: среду 
отправляться: отправлялись отправились 
место: места месте мест местам место 
заранее: заранее 
последний: последнего последний последние 
секрет: секрете 
план: план плана 
действие: действий 
играть: играли играл 
неоновый: неоновый 
объездить: объездили 
красивый: красивые красивая 
прокатиться: прокатились 
стеклянный: стеклянным 
дно: дном 
утопать: утонули 
полет: полета 
парасейл: парасейле 
цена: цен цены цена 
скажем: скажем 
организация: организацию 
заплатить: заплатили заплатила 
около: около 
бывать: бывают 
бюджетный: бюджетных бюджетные 
приносить: приносите приносят приносили приносит 
масса: масса массу 
понравиться: понравились понравившиеся понравилось 
космонавтика: космонавтики 
билет: билеты билетов билета билету билет 
туда: туда 
продавать: продают 
нужно: нужно 
знать: знать 
непредсказуемый: непредсказуемое 
будущее: будущем будущее будущего 
теория: теории 
кажется: кажется 
разумный: разумным 
инвестировать: инвестировать 
отказывать: отказывать 
все: всем всему 
ради: ради 
загадочный: загадочных 
перспектива: перспектив 
пенсия: пенсии пенсия 
уверенность: уверенности 
наступать: наступит наступила 
возможно: возможно 
быть: будь буду будут 
обливаться: обливаться 
крокодилий: крокодильими 
слеза: слезами 
повод: поводу 
большой: больших большую большой большого большими 
часть: часть 
взрослый: взрослой 
счастливый: счастливой счастлива счастливый счастливы 
слушать: слушая слушаю 
социум: социума 
сам: сама 
пожелать: пожелаю 
следовать: следовать 
дурацкий: дурацким 
запихивать: запихивает запихивать 
рамка: рамках рамки 
искать: ищу искать искала 
идея: идеей идеи 
туристический: туристические 
пакетный: пакетные 
удовольствие: удовольствие удовольствия 
обычно: обычно 
вариант: варианта вариант варианты 
поисковик: поисковике поисковик 
перелет: перелеты перелета перелетов перелет 
специальный: специальные 
агрегатор: агрегаторы 
дешевый: дешевый дешевые дешевых 
маршрут: маршруты 
поиск: поиску поисках поиска 
гугл: гугле 
приводить: привести приведу 
давно: давно 
попросить: попросил попросили 
отыскивать: отыскать 
даллас: даллас далласа 
предлагать: предложил предлагают 
багаж: багажом 
короткий: короткими короткую 
пересадок: пересадками 
такой: такая такому такое таких такие такую 
пересадка: пересадки 
неудобный: неудобные 
длинный: длинные 
стыковка: стыковки стыковкой стыковками 
поспать: поспать 
отель: отеля отеле отель 
напрямую: напрямую 
авиакомпания: авиакомпанией авиакомпании 
двое: двоих 
сторона: сторону стороны 
второй: второй второго 
прямой: прямой 
стамбул: стамбула стамбул 
оттуда: оттуда 
франкфурт: франкфурте 
улетать: улетала улететь 
авиалиния: авиалиниями 
рейс: рейс 
самостоятельно: самостоятельно 
организовывать: организовывают организовать организовала организовали организовывать 
кругосветный: кругосветное 
вводить: ввести 
запрос: запросы 
тип: типа 
необычный: необычных 
ссылка: ссылки 
добавлять: добавляем добавляю 
браузер: браузера 
реализовывать: реализовать 
составлять: составить составила 
нетривиальный: нетривиальный 
обратно: обратно 
ереван: ереван 
тбилиси: тбилиси 
доха: доху 
бойсе: бойсе 
штат: штате 
айдахо: айдахо 
полететь: полетели 
два: две двух двумя 
путеводитель: путеводителя путеводители 
отдельный: отдельные 
тревелхак: тревелхаки 
мимолетом: мимолетом 
читать: читала читать 
книга: книги книгах 
lonely: lonely 
planet: planet 
eurail: eurail 
pass: pass 
единый: единый 
проездной: проездной 
поезд: поезда 
спланировать: спланировать 
супербюджетный: супербюджетное 
неделя: недели неделю 
бюджет: бюджета бюджетом 
рассказ: рассказы 
знакомый: знакомым знакомый знакомых знакомы 
некоторые: некоторых 
вещь: вещах вещами вещи 
слышать: слышала 
родственный: родственная 
касабланка: касабланке 
шаманский: шаманский 
обряд: обряд 
общение: общения 
духи: духами 
практиковать: практиковать 
перо: перу 
загораться: загорелась 
обязательно: обязательно 
немой: нем 
поучаствовать: поучаствовать 
мечеть: мечеть 
наткнуться: наткнулась 
ехать: еду ехать ехала ехали едут 
пляж: пляж 
оказываться: окажетесь оказывается оказывались оказалась оказалось 
здание: зданий зданиях здание 
город: города городе город городах 
окружать: окруженная окруженные 
нищета: нищетой 
хасан: хасана 
случайно: случайно 
таксист: таксист 
подвозить: подвозил 
подсказывать: подсказал 
испытывать: испытать 
парасейлинг: парасейлинг 
минута: минут 
незабываемый: незабываемого 
посреди: посреди 
останавливаться: останавливаться остановиться остановилась останавливались 
рухнуть: рухнули 
вода: воду 
тематический: тематические тематическую 
мероприятие: мероприятий мероприятие мероприятия 
увлекаться: увлекалась 
электронный: электронной 
коммерция: коммерцией 
блокчейн: блокчейном 
криптовалюта: криптовалютами криптовалютам криптовалюту 
отраслевой: отраслевые 
посещать: посетить 
конференция: конференции конференций конференцию конференция 
киев: киев 
гибралтар: гибралтар 
калифорния: калифорнии 
известный: известный известных 
affiliate: affiliate 
world: world 
бангкок: бангкоке 
барселона: барселоны барселоне 
берлин: берлине 
биржа: бирже 
предел: пределами пределах 
ценный: ценное 
встреча: встречи встреча 
мыслить: мыслят 
аналогичный: аналогичные аналогичный аналогичным 
образ: образом образ 
совершенно: совершенно 
незапланированный: незапланированные 
блогер: блогером 
таять: таем тай 
лопез: лопез лопезом 
подробно: подробнее 
экскурсия: экскурсия экскурсии экскурсий экскурсию 
бронировать: бронировала 
развлечение: развлечений развлечение развлечения 
описание: описания 
тур: туров тур туры 
факт: факту 
ожидать: ожидала 
пойти: пошли пойду пошла 
масонский: масонской 
скакать: скакали 
центр: центру центров центре 
ключевой: ключевым ключевых 
сохраняться: сохранившихся 
никакой: никаких никакого 
масон: масонов 
подобный: подобных подобном 
раздел: раздел 
experiences: experiences 
airbnb: airbnb 
взгляд: взгляды взгляд 
организатор: организаторы организаторам 
участник: участники 
исполнение: исполнение 
интересно: интересней интересно поинтереснее 
лениться: ленюсь 
заниматься: занималась 
сходить: сходила сходить 
частный: частном частную частной 
сигарный: сигарную 
фабрика: фабрику 
скручивать: скрутила 
сигара: сигару 
курить: курю 
любопытно: любопытно 
опробовать: опробовала 
вкусный: вкусные 
индийский: индийские 
китайский: китайские 
забегаловка: забегаловки 
писатель: писателем 
квинс: квинса 
погулять: погуляла 
комиссионка: комиссионкам 
стилист: стилистом 
проезжаться: проехалась 
винодельня: винодельням винодельнях 
округ: округа 
нап: напа 
калифорнийский: калифорнийским 
предприниматель: предпринимателем 
временный: временную 
татуировка: татуировку 
художница: художницы 
разброс: разброс 
любимый: любимых любимое любимая 
я: мной 
неизбитый: неизбитым 
побережье: побережья побережью 
ужинать: ужинали 
маленький: маленьком маленькой 
рыбацкий: рыбацкой 
деревенька: деревеньке 
впечатлять: впечатляет впечатляющих впечатляющий 
изготовление: изготовлению 
азулеж: азулежу 
расписной: расписной 
португальский: португальской 
плитка: плитки 
медитативный: медитативное 
вдохновлять: вдохновляющее 
занятие: занятие занятий 
сегодняшний: сегодняшняя 
час: часа час часов 
автопутешествие: автопутешествие 
забронировать: забронировал забронировать забронировала 
сложно: сложно сложнее 
обращаться: обращалась 
картинка: картинкам 
социальный: социальные 
сеть: сети 
платить: платил платила платить платили 
наличные: наличными 
дешево: дешевле 
платформа: платформе 
память: памяти 
гастротур: гастротур 
вино: вином 
морепродукт: морепродуктами 
источник: источник источников 
расписывать: расписывать 
традиционный: традиционные 
изразец: изразцы 
штука: штука 
субъективный: субъективная 
гончарный: гончарного гончарной гончарному 
искусство: искусству искусство искусства 
поворотный: поворотной 
восхождение: восхождение восхождением 
эверест: эверест 
впечатлить: впечатлило впечатлить 
запоминаться: запомнились запоминающиеся 
криптоиндустрия: криптоиндустрии 
маркетинговый: маркетинговым 
консалтинг: консалтингом 
писать: писали писала писал 
заметка: заметку заметки 
богатый: богатом богатых богатой 
зимовка: зимовки зимовку 
зима: зимой зимы 
следующий: следующем следующий следующие 
продлиться: продлилась 
остин: остине остин 
лима: лима лиме 
канкуна: канкуне 
посчитать: посчитала 
жилье: жилье 
отдавать: отдала 
потратить: потратить потратила 
афин: афины 
канкун: канкун 
активно: активно 
ходить: ходить ходил ходили хожу ходят ходила 
митапа: митапы 
криптоконференция: криптоконференции 
участие: участие 
знакомиться: знакомилась 
интервью: интервью 
весь: весь вся 
январь: январь 
проводить: провел проводить проводящих проводим провела 
попадать: попадают попала попали 
крупный: крупнейшую 
north: north 
american: american 
bitcoin: bitcoin 
conference: conference 
tnabc: tnabc 
главный: главной главные 
цель: целью 
вписываться: вписывалась 
готовый: готов готова 
потенциальный: потенциальных 
спикер: спикеров 
публикация: публикаций 
длиться: длилась длится 
включать: включал 
доклад: доклады 
заканчиваться: заканчивался 
начало: начале 
пересекаться: пересеклась 
старый: старых старой старым 
криптосфера: криптосферы 
запускать: запускал 
собирать: собрал 
куча: кучу кучей 
среди: среди 
венчурный: венчурных 
капиталист: капиталистов 
качество: качестве 
устраивать: устроить 
закрытый: закрытую 
позвать: позвал 
соглашаться: согласилась 
поставлять: поставил поставлять поставить 
невидимый: невидимую 
печать: печать 
пропускать: пропускали 
трансфер: трансфер 
отбывать: отбывал 
лес: лес леса 
полночь: полночь 
глаз: глаза 
надевать: надевали 
повязка: повязки 
местонахождение: местонахождение 
привозить: привезли 
обрыв: обрыве 
вид: виды видов видом виде 
море: море 
роскошный: роскошный 
бассейн: бассейна 
парочка: парочка 
джакузи: джакузи 
огромный: огромный огромная 
терраса: терраса террасой 
камин: камин 
холл: холл 
диджей: диджей 
хвалиться: хвалился 
клип: клипа клипе 
carry: carry 
исполнитель: исполнителя 
kygo: kygo 
обманывать: обманул 
кадр: кадром кадр 
засвечиваться: засветился 
kygomusic: kygomusic 
проходить: прошла проходила проходят прошел 
хороший: лучшие лучшей лучших хорошие хорошее 
американский: американских 
фильм: фильмов фильм 
подросток: подростков 
алкоголь: алкоголь алкоголя 
владелец: владельцем 
франшизный: франшизных 
пить: пью пить 
вокруг: вокруг 
пьяный: пьяны 
беседовать: беседовать 
они: ними 
значимость: значимости 
человечество: человечества 
хихикать: хихикали 
наблюдать: наблюдать наблюдали 
ночь: ночь ночи 
собираться: собралась собираюсь 
домой: домой 
сталкиваться: столкнулась 
кумир: кумиром 
инвестор: инвестор 
финансовый: финансовый финансовые финансовой 
консультант: консультант 
долларовый: долларовых 
ненавидеть: ненавидели 
попадаться: попадалась попалось 
навязчивый: навязчивая 
очередной: очередных 
бесить: бесила бесите 
веселить: веселила 
накидываться: накинулась 
таить: тая 
дикий: дикий 
зверь: зверь звери 
совместный: совместная совместный совместных совместное 
фото: фото 
хотя: хотя 
вольность: вольности 
селфи: селфи 
телефон: телефон 
немного: немного 
поговорить: поговорили 
затем: затем 
запланировать: запланировать 
повторять: повторить повторять 
интроверт: интроверт 
раз: разы раза 
достаточно: достаточно 
ощущение: ощущение 
соприкасаться: соприкоснулась 
ум: умами 
важный: важное важного 
нужный: нужны нужен нужное 
непередаваемый: непередаваемо 
посвящать: посвященные 
мема: мемы 
спасать: спасенных 
животный: животных 
пара: пару 
полуостров: полуострове 
юкатан: юкатан 
конец: конца концов концу конце 
считать: считала 
еженедельный: еженедельных 
экологический: экологический 
животное: животные 
основное: основном 
плохой: плохих 
условие: условий условиях 
жестокий: жестоких 
разоряться: разорившихся 
цирк: цирков 
лаборатория: лабораторий 
эксперимент: эксперименты 
оно: оно 
территория: территории 
также: также 
глэмпинг: глэмпинг 
поехать: поехать поехали 
ночевка: ночевки 
выпивать: выпивал выпить 
кофе: кофе 
футболка: футболку 
поддерживать: поддержать 
приют: приютах 
городок: городке 
км: км 
акумаль: акумаль 
добираться: добирались 
коллективо: коллективо 
маршрутка: маршрутки 
песо: песо 
прямо: прямо 
транспорт: транспорте 
содержать: содержать 
коренная: коренные 
майя: майя 
лесенка: лесенок 
тропинка: тропинок 
типичный: типичных 
хижина: хижин 
предмет: предметами 
народ: народа 
птица: птицы 
вне: вне 
вольер: вольеров 
сто: ста 
фазан: фазанов 
хоко: хоко 
крокодил: крокодилов 
паукообразный: паукообразных 
обезьяна: обезьян 
белохвостый: белохвостых 
олень: оленей 
попугай: попугаев 
посмотреть: посмотрели 
улей: ульи 
местный: местными местных местные 
безжальный: безжальных 
пчела: пчел 
исключительно: исключительно 
целительный: целительный 
мед: мед 
искупаться: искупались 
карстовый: карстовом 
провал: провале 
подземный: подземными 
вод: водами 
гид: гидом гид гиды 
растение: растениях 
использование: использовании 
себя: собой 
травяной: травяной 
чай: чай 
боль: боли болей 
почка: почках 
страдать: страдал 
чудо: чудо 
оценка: оценок 
билли: билли 
айлиш: айлиш 
сказать: сказать 
обезьяний: обезьянье 
рукопожатие: рукопожатие 
специально: специально 
природа: природу природа 
поблизости: поблизости 
советовать: советую 
самостоятельный: самостоятельное 
сенот: сенот 
сессия: сессия сессии сессию 
медиум: медиума медиумом 
понемногу: понемногу 
тулум: тулуме тулум 
передвигаться: передвигались 
автобус: автобусы автобусах 
комфортный: комфортные комфортными 
кондиционер: кондиционерами 
недолго: недолго 
касса: кассе 
автовокзал: автовокзала 
ado: ado 
мексиканский: мексиканские мексиканской 
автобусный: автобусной 
компания: компании 
состояние: состояния 
здоровый: здоров 
слабый: слаб 
дышать: дышит 
сюрприз: cюрпризы 
частенько: частенько 
подкидывать: подкидывает 
столько: столько 
активный: активных 
лекарь: лекарей 
руины: руин руинам руины 
тина: тиной тину 
десять: десять 
проплывать: проплыли 
нырять: нырять 
череп: черепах 
спокойный: спокойные 
атмосфера: атмосфера 
современный: современное современного 
тулумский: тулумских 
джунгли: джунглях 
околодуховность: околодуховностью 
йога: йоги 
медитация: медитации 
чистка: чистки 
аура: ауры 
некий: некий некоем некое 
старичок: старичке 
пачка: пачку пачками 
зажиточный: зажиточные 
американец: американцы 
волновой: волновую 
терапия: терапии терапию 
сеанс: сеанс 
сидеть: сиди сидела сидел 
рядом: рядом 
подержать: подержать 
скука: скуки 
обвешивать: обвешивали 
датчик: датчиками 
излучать: излучают 
частота: частоты 
якобы: якобы 
убивать: убивать 
всякий: всяких 
паразит: паразиты паразитов 
скоро: скорей скорее 
эффективный: эффективное 
подозревать: подозреваю 
интересовать: интересуют 
медитационный: медитационные 
практик: практики 
вопрос: вопросы вопрос 
происхождение: происхождения 
сознание: сознания 
особо: особо 
духовный: духовна духовных 
точный: точного 
ответ: ответа 
наука: наука 
тема: теме тему 
пока: пока 
приходиться: приходится 
выяснять: выяснять 
конкретно: конкретно 
увидеть: увидела 
самопознание: самопознания 
прошлый: прошлой прошлых 
проблема: проблемы проблемах проблеме 
настоящий: настоящем 
возможный: возможном 
записываться: записаться 
индивидуальный: индивидуальный индивидуальные 
полуторачасовой: полуторачасовые полуторачасовой 
оплата: оплату 
целитель: целители 
переводить: перевести 
отдельность: отдельности 
кабинет: кабинете 
ложиться: лечь 
кушетка: кушетку 
закрывать: закрыть закрывать 
думать: думать думаю 
милый: милая 
целительница: целительница целительницы 
жечь: жгла 
свеча: свечи 
роза: розой 
всяческий: всяческими 
ароматический: ароматическими 
масло: маслами 
немножко: немножко 
напевать: напевала 
входить: вошли 
подобие: подобие 
транс: транса 
делиться: делилась 
видение: видениями 
относительно: относительно 
прошлое: прошлого 
танцовщица: танцовщицей 
танцевать: танцевала 
уставать: устали 
потеха: потеху 
жестокосердный: жестокосердному 
император: императору 
заточение: заточении 
башня: башне башню 
король: королем 
никак: никак 
проникать: проникнуть 
ко: ко 
сюрреализм: сюрреализм 
поверять: поверила поверьте 
локальный: локальные 
очередь: очередь 
поклонник: поклонник 
отрыв: отрыве 
цивилизация: цивилизации 
единственный: единственное 
основательно: основательно 
родной: родной 
навещать: навещать 
трижды: трижды 
лето: летом 
весна: весной 
выбираться: выбираемся 
однодневный: однодневные 
приезд: приезды приезд 
ребята: ребят 
авторский: авторские 
поплыть: поплыли 
анива: анива 
вспоминать: вспоминает 
лодочный: лодочное 
негодование: негодованием 
продрогнуть: продрог 
нитка: нитки 
посадка: посадки 
заплыв: заплыв 
занимать: занял 
довольный: доволен 
крабалка: крабалку крабалке 
ловить: ловлю 
краб: крабов 
рыбак: рыбака 
необходимый: необходимым 
снаряжение: снаряжением 
сопровождать: сопроводить 
натренировать: натренировать 
особенно: особенно 
тяжело: тяжело 
каблук: каблуках каблуками 
рекомендовать: рекомендую 
одеваться: одеваться 
тепло: теплее 
обуваться: обуваться 
удобно: удобнее 
мыс: мыс 
птичий: птичий 
евстафия: евстафия 
изумрудный: изумрудные 
озеро: озера 
сивуч: сивучами 
тюлень: тюленями 
тори: тори 
ворота: ворота 
умерший: умерших 
покидать: покидают 
переходить: переходят перешла 
потусторонний: потусторонний потусторонними 
японец: японцы 
оккупация: оккупации 
десяток: десятки 
ворот: ворот 
вдвоем: вдвоем 
вчетвером: вчетвером 
выгодно: выгодно 
сахалинский: сахалинским 
пытаться: пытался пытаюсь 
запачкаться: запачкаться 
бирюзовый: бирюзовые 
какой: какие каким 
концерт: концерт концерты 
выставка: выставки 
недавний: недавнего 
подруга: подругой 
серебряный: серебряное серебряные серебряных 
кольцо: кольцо колец кольца 
цех: цехе 
познавательный: познавательно 
слепить: слепили 
миска: миске 
изделие: изделие 
корявый: корявое 
вполне: вполне 
использовать: использовать 
подставка: подставку 
благовоние: благовоний 
бистро: бистро 
коммуналка: коммуналке 
кафе: кафе 
вылазка: вылазка 
марс: марс марсе 
бродить: бродили 
картина: картин 
моне: моне 
мунок: мунка 
обычный: обычный 
темнота: темноте 
странно: странно 
забавно: забавно 
загонять: загонять 
мяч: мяч 
лунка: лунку 
игра: игр игру 
сожаление: сожалений сожалению 
закрываться: закрылся 
гольф: гольф 
хохот: хохота 
небольшой: небольшую небольшие 
урок: уроки уроков 
практика: практику практика 
шитье: шитья 
восемь: восемь 
вокал: вокала вокалу 
базовый: базовый 
стрельба: стрельбы 
акварельный: акварельному 
рисунок: рисунку 
обходиться: обошелся 
скидочный: скидочному 
купон: купону 
оптический: оптических 
иллюзия: иллюзий 
лютеранский: лютеранском 
мозаика: мозаике 
смальта: смальты 
таблица: таблице таблица 
ниже: ниже 
постараться: постаралась 
неполный: неполная 
наверняка: наверняка 
забывать: забыла 
минимум: минимум 
автотур: автотур 
афинский: афинским 
клуб: клуб 
крушить: крушить 
мастерская: мастерской 
снорклинг: снорклинг 
осмотр: осмотр 
гонки: гонки 
заставлять: заставило 
попытка: попыток попытках попытка 
половина: половину 
область: области 
усреднять: усреднить 
пандемия: пандемии 
лишь: лишь 
слетать: слетала 
остальное: остальное 
криптокарьера: криптокарьеры 
результат: результате 
волшебный: волшебное 
площадь: площадью 
м²: м² 
балкон: балконом 
плюс: плюс 
возможность: возможность возможности 
надстраивать: надстроить 
этаж: этаж 
расширять: расширить 
жилплощадь: жилплощадь 
поздно: позже 
жена: жена 
спускаться: спускалась 
хвост: хвост 
кошка: кошке 
житься: живется 
пентхаус: пентхаусе 
отделка: отделки 
заканчивать: закончила 
земля: земле 
рано: раньше 
оглядка: оглядкой 
ждать: ждут 
общество: общество 
восхищаться: восхищаться 
приятель: приятелями 
лофт: лофт 
заводить: заводить завели 
кот: кота 
нормальность: нормальность 
рутина: рутина 
отвлекать: отвлекали 
призывать: призываю 
потребность: потребности 
почувствовать: почувствовала 
полноценный: полноценной 
начинать: начала 
возмущаться: возмутиться 
инфантильно: инфантильно 
эгоистично: эгоистично 
жаль: жаль 
упускать: упущенные 
подстраиваться: подстраивалась 
ожидание: ожидания 
изменяться: изменилась 
свободный: свободных 
неизлечимый: неизлечимое 
аутоиммунный: аутоиммунное 
заболевание: заболевание 
процесс: процесс 
участвовать: участвуют 
превращать: превратить 
тинькофф: тинькофф 
журнал: журнала 
прочитывать: прочитать прочитайте 
мануал: мануал 
заявка: заявку 
подписываться: подписаться 
тэг: тэги 
увлечение: увлечения 
simonskafar: simonskafar 
istock: istock 
пожалеть: пожалели 
комментарий: комментарии 
модерация: модерацию 
майский: майская 
герой: герой 
рад: рады 
отвечать: ответить 
маргарита: маргарита 
з: з 
яблочко: яблочко 
кратко: кратко 
нечего: нечем 
дополнять: дополнить 
user: user 
дмитрий: дмитрий 
никонов: никонов 
грузчик: грузчика грузчиком 
угнетение: угнетения угнетение 
светлана: светлана 
тойкина: тойкина 
гораздо: гораздо 
настроение: настроением 
выпрямлять: выпрямляй 
волос: волосы волосами 
кудри: кудри 
непрофессионально: непрофессионально 
носить: носи 
плотный: плотные плотных 
колготки: колготки 
свобода: свободу 
предпринимательство: предпринимательство 
ряд: ряде 
оригинальный: оригинальный 
срабатывать: сработал 
mikhail: mikhail 
panov: panov 
колгота: колготах 
pavel: pavel 
yegorov: yegorov 
митино: митино 
прощать: прости 
господи: господи 
сосед: соседи соседом 
васян: васян 
именно: именно 
дикси: дикси 
бутылка: бутылку 
водка: водки 
пельмень: пельменями пельменей 
телик: телик 
бутылочка: бутылочку 
водочка: водочки 
заедать: заедал 
буквально: буквально 
встречаться: встречался 
сокол: сокол 
уайт: уайт 
склад: складе 
осень: осенью 
бежать: бежал 
сверкать: сверкая 
пятка: пятками 
спина: спина 
нога: ноги 
отваливаться: отваливались 
ибо: ибо 
сила: сил 
вишенка: вишенка 
торт: торте 
угнетатель: угнетатель 
командовать: командует 
тупой: тупее 
радоваться: радовался 
адекватный: адекватнее 
собственно: собственно 
что: чему 
georgiy: georgiy 
nikulin: nikulin 
воспринимать: восприняли воспринимать 
девушка: девушка 
честно: честно 
материал: материал 
p: p 
рассмешить: рассмешила 
уморительный: уморительно 
смешно: смешно 
тьфунатебать: тьфунатебя 
легенда: легенда 
дарья: дарья 
чето: чето 
абзац: абзаца 
заработок: заработок 
тысяча: тысяч 
глеб: глеб 
жеглов: жеглов 
минуточка: минуточку 
invest: invest 
knowledge: knowledge 
сразу: сразу 
уходить: уходить ухожу 
коммент: комменты 
marcus: marcus 
mcfray: mcfray 
riberu: riberu 
даваться: даешься 
фантастика: фантастика 
николай: николай 
корнев: корнев 
вера: вера 
черниченко: черниченко 
легко: легко 
миссис: миссис 
фокс: фокс 
радовать: радовали радует 
внутренний: внутреннего 
написаго: написаго 
коспенсация: коспенсация 
некто: некто 
везти: повезло 
метро: метро 
пешком: пешком 
возникать: возникали возникла 
перевертывать: перевернула 
ваш: ваш вашу ваши 
aigul: aigul 
alexandra: alexandra 
отредактировать: отредактировано 
намного: намного 
целое: целом 
разделять: разделяю 
она: её 
радость: радости радость 
скупиться: скуплюсь 
кино: кино 
театр: театры театр 
посидеть: посидеть 
поесть: поесть 
менее: менее 
отражать: отразить 
видимо: видимо 
треск: треском 
проваливаться: провалилась 
дело: делу дело 
стоимость: стоимости 
подход: подходе 
принцип: принципе 
счастие: счастья счастье 
сознательно: сознательно 
отказываться: отказалась отказались 
достойный: достойной 
обозначать: обозначить 
елена: елена 
познавать: познать 
слава: слава 
бог: богу 
сергей: сергей 
полтавец: полтавец 
лукавить: лукавите 
дядин: дядиной 
размер: размеру 
хотелка: хотелки 
требовать: требуют 
приличный: приличных 
андрей: андрей 
вернуться: вернулись 
уровень: уровень 
boris: boris 
объект: объект 
повышать: повышаем 
ценник: ценник 
экстаз: экстазе 
anna: anna 
алексей: алексей 
надеяться: надеюсь 
исчезать: исчезающее 
малый: малое 
количество: количество 
luna: luna 
moonlight: moonlight 
впихивать: впихнуть 
фотка: фотки 
описывать: описанная описывают 
доставка: доставок 
еда: еды 
бросать: бросайте бросили 
дауншифтить: дауншифтить 
азия: азию 
рубль: рублей 
партнер: партнером 
доллар: долларов 
перепадать: перепадало 
суть: суть 
показ: показ 
высокооплачиваемый: высокооплачиваемую высокооплачиваемой 
бла: бла 
надежный: надежного 
стабильный: стабильных 
поддержка: поддержки 
близкие: близких 
mr: mr 
zombie: zombie 
зп: зп 
чистокровный: чистокровных 
маг: магов 
хогвартс: хогвартсе 
иметь: имеет 
смысл: смысла 
удаленка: удаленки 
хукабур: хукабура 
здорово: здорово 
главное: главное 
никто: никто 
жалеть: жалеть 
исследовать: исследовал 
mary: mary 
brandybuck: brandybuck 
unapologetic: unapologetic 
republican: republican 
назад: назад 
вывод: выводы 
спокойно: спокойно 
филипп: филипп 
доставаться: досталось 
гражданство: гражданство 
михаил: михаил 
алекперов: алекперов 
чужой: чужими 
выглядеть: выглядят 
успех: успеха 
голова: головой 
завидовать: завидовать 
открывать: открывать 
обедать: обедать 
крутой: крутым 
монах: монахам 
простой: простых проста 
доширак: доширак 
плакать: плакать 
полька: полька 
чувство: чувство чувства 
юмор: юмора 
должно: должно 
ксения: ксения 
александра: александра 
кондратьев: кондратьева 
различный: различные 
флористика: флористике 
рисование: рисованию 
килограмм: килограммы 
эмоция: эмоции 
неподдельный: неподдельные 
sonata: sonata 
solaris: solaris 
мозги: мозги 
мечтать: мечтают 
уметь: умеют 
привязка: привязки 
нахождение: нахождению 
способность: способности 
вытекать: вытекающие 
елизавета: елизавета 
имхо: имхо 
больший: большая 
лям: лям 
счастливо: счастливее 
негативный: негативное 
схема: схеме 
переломный: переломный 
принимать: принял 
решение: решение 
поменять: поменять 
фотография: фотографии 
мотивировать: мотивирует 
несчастный: несчастной 
успешный: успешной 
визажист: визажистом 
пользоваться: пользовалась 
маникюр: маникюр 
кудрявый: кудрявый 
метод: метод 
уход: уход ухода 
съездить: съездила 
випассан: випассану 
общественный: общественную 
баня: баню 
марафон: марафоны 
похудение: похудения 
создание: создание 
целый: целый 
архив: архивах 
информация: информацию 
репрессировать: репрессированной 
прабабушка: прабабушке 
научаться: научилась 
плавать: плавать 
пермь: перми 
катер: катер 
короткометражный: короткометражный 
раскручивать: раскрутить 
готовить: готовить 
технология: технологии 
мошенник: мошенникам 
понадобиться: понадобились 
справка: справки 
репетитор: репетитор 
полагаться: полагался 
каникулы: каникулы 
налог: налог налоги 
инвалидность: инвалидностью 
балл: баллы 
уведомлять: уведомлять 
счет: счет счетах 
белоруссия: белоруссии 
работник: работник 
работодатель: работодателю 
ипать: ип 
оформлять: оформить 
риск: риски 
сотрудничать: сотрудничают 
иностранный: иностранным 
заливать: залили 
дверной: дверную 
ручка: ручку 
замок: замок 
клей: клеем 
протест: протест 
завещание: завещание 
имущество: имущество 
баланс: баланс 
косметичка: косметичка 
чувствительный: чувствительной 
комбинированный: комбинированной 
кожа: кожей 
акна: акне 
последствие: последствия 
покупатель: покупателя 
продавец: продавец 
вносить: внесет 
доля: доли 
вернуть: вернуть 
обучение: обучение 
отрабатывать: отработала 
срок: срок 
целевой: целевому 
договор: договор договору 
процент: проценты 
популярный: популярное 
посылка: посылка 
застревать: застряла 
таможня: таможне 
стаут: стауты 
гоза: гозе 
ламбик: ламбики 
крафтовый: крафтовое 
пиво: пиво 
бали: бали 
въезд: въезда 
сербия: сербию 
россиянин: россиян 
мнение: мнение 
поколение: поколение 
рынок: рынке 
труд: труда 
беспроводный: беспроводные 
колонка: колонки 
удачный: удачных 
модель: моделей 
директор: директор 
розничный: розничной 
поволжье: поволжье 
экономист: экономист 
дежурный: дежурный 
электромонтер: электромонтер 
новосибирск: новосибирске 
apple: apple 
watch: watch 
вакансия: вакансии 
сообщать: сообщить 
контакт: контакты 
политика: политика 
конфиденциальность: конфиденциальности 
пользование: пользования 
ао: ао 
банк: банк 
лицензия: лицензия 
