поток: потоки 
учебник: учебник 
сравнятор: сравнятор 
сообщество: сообщество 
ипотека: ипотека 
кредитный: кредитная 
история: история истории 
тест: тесты 
дневник: дневники дневник 
трата: траты трат 
налоговый: налоговый 
вычет: вычет вычеты 
написать: написать 
инвестиция: инвестиции 
бизнес: бизнес бизнеса 
разбор: разборы 
закон: законов 
калькулятор: калькуляторы 
путешествие: путешествиях путешествии путешествия 
медицина: медицина 
здоровье: здоровье 
недвижимость: недвижимость 
подкаста: подкаст подкасты 
видео: видео 
смотреть: смотреть 
сервис: сервисы 
расчет: расчеты 
закладка: закладки 
письмо: письма письмо 
оставаться: оставайтесь 
деньги: деньгами деньги 
тема: темы 
который: которых 
писать: пишут пишем 
журнал: журнале 
инвестидея: инвестидеи 
инвестразбор: инвестразборы 
компания: компании 
начинающий: начинающих 
продвигать: продвинутых 
новость: новости 
инвестор: инвесторов 
инвестировать: инвестировать 
экономика: экономика 
мир: миру 
россия: россия россии 
путешественник: путешественников 
право: права правах 
безопасность: безопасность 
стоять: стоит 
съездить: съездить 
релокация: релокация 
читатель: читатели читателей 
путешествовать: путешествуют 
нога: ногой 
эмигрировать: эмигрируют 
город: города город 
эмиграция: эмиграция 
весть: вести 
кейс: кейсы 
открывать: открыли 
провал: провал провалы 
мнение: мнения 
предприниматель: предпринимателей 
правовой: правовая 
грамотность: грамотность грамотности 
обязанность: обязанности обязанностях 
брак: брак 
развод: разводы 
памятка: памятка 
работник: работнику 
наследство: наследство 
ваш: ваши 
изумительный: изумительные 
дайджест: дайджест 
должный: должны 
суд: суды 
теория: теория 
практика: практика 
защищать: защищают 
свой: свои 
уголок: уголок 
потребитель: потребителя 
судебный: судебные 
спорт: спорт спорта 
киберспорт: киберспорт 
вкатиться: вкатиться 
кабинет: кабинет 
физиотерапевт: физиотерапевта 
деталь: деталях 
спортзал: спортзал 
общество: общество 
благотворительность: благотворительность 
важный: важные важном 
статистика: статистика 
экология: экология 
добрый: добрые 
дело: дела 
делать: делать делают 
кризис: кризис 
пенсия: пенсия 
налог: налоги 
выплата: выплаты 
льгота: льготы 
образование: образования образование 
хобби: хобби 
учеба: учеба 
граница: границей границ 
увлечение: увлечения 
университет: университеты 
учиться: учатся 
трудность: трудности 
перевод: перевода 
рабочий: рабочие 
место: место места 
аренда: аренда 
покупка: покупка покупки 
продажа: продажа 
жкх: жкх 
дача: дачи 
загородный: загородные 
дома: дома 
район: район 
ремонт: ремонт 
обустройство: обустройство 
жить: живу 
продавать: продают 
покупать: покупают 
жилье: жилье 
переезжать: переезжают 
обезопасить: обезопасить 
близкие: близких 
прищур: прищуром 
здоровый: здоровым 
медновость: медновости 
проверка: проверка 
слух: слуха 
вопрос: вопросы вопроса 
доктор: доктору 
косметичка: косметичка 
болезнь: болезни 
питание: питания 
худеть: худеют 
беременность: беременность 
роды: роды 
брекет: брекеты 
корректировать: корректируют 
зрение: зрение 
мозг: мозг 
продуктивность: продуктивность 
психотерапия: психотерапии психотерапия 
совет: советов 
путеводитель: путеводитель 
психика: психике 
разговор: разговор 
психолог: психологу психологом 
рассказывать: рассказывают 
потратить: потратить 
сэкономить: сэкономить 
еда: еда 
проверять: проверяем 
миф: мифы 
зарабатывать: зарабатывать 
работа: работа 
зарплата: зарплата 
дополнительный: дополнительный 
доход: доход 
брать: берем 
контроль: контроль 
финансы: финансы 
бюджет: бюджет бюджеты 
экономия: экономия 
долг: долги 
кредит: кредиты 
семья: семья 
питомец: питомцы 
ребенок: дети ребенком ребенка 
жизнь: жизни жизнь 
декрет: декрете 
пойти: пойти 
родительство: родительство 
животное: животные 
автомобилист: автомобилистам 
авто: авто 
автоновость: автоновости 
машина: машины 
технология: технологии 
техноновость: техноновости 
технообзор: технообзоры 
техноподборка: техноподборки 
техноностальгия: техноностальгия 
собирать: собирают 
компьютер: компьютеры 
нейрогалерея: нейрогалерея 
интерактив: интерактив 
тот: тех 
хотеть: хочет 
узнавать: узнать 
кто: кому 
нечего: нечем 
заниматься: заняться 
эрудированный: эрудированных 
финансовый: финансовое финансовых финансовые финансовой 
чутье: чутье 
беспощадный: беспощадные 
искать: ищет 
сохранять: сохранить 
злободневный: злободневные 
один: одного 
б: б 
шоу: шоу 
цель: целях 
второй: второй 
сезон: сезон 
заявка: заявки 
первый: первый 
профессия: профессии 
дискуссия: дискуссии 
бесить: бесит 
экселек: эксельки 
плохой: худшие 
карьера: карьеры 
ama: ama 
ожидание: ожидания 
реальность: реальность 
познакомиться: познакомьтесь 
против: против 
сортировать: сортировать 
правило: правила 
библиотека: библиотека 
жалеть: жалею 
урок: уроки 
кафе: кафе 
бар: бары 
киноклуб: киноклуб 
кошмар: кошмары 
горизонт: горизонт 
планирование: планирования 
хороший: лучшие 
год: годы 
день: день 
вакансия: вакансии 
сообщать: сообщить 
проблема: проблеме 
проект: проекте 
контакт: контакты 
политика: политика 
конфиденциальность: конфиденциальности 
пользование: пользования 
сайт: сайтом 
выходить: выйти 
ао: ао 
банк: банк 
лицензия: лицензия 
