акция: акцию акции акций 
headhunter: headhunter 
вырастать: выросли 
сделка: сделкой сделки 
kismet: kismet 
capital: capital 
ждать: ждет 
рынок: рынок рынке 
промой: промо 
это: это 
кредитка: кредитка 
лимит: лимитом 
изучать: изучить 
карта: карту 
учебник: учебник 
сравнятор: сравнятор 
сообщество: сообщество 
ипотека: ипотека 
кредитный: кредитная 
история: история 
тест: тесты 
дневник: дневники дневник 
трата: трат 
налоговый: налоговые налоговую налоговый 
вычет: вычет 
написать: написать 
инвестиция: инвестиции инвестициях инвестициями 
бизнес: бизнес бизнеса 
разбор: разборы 
закон: законов 
калькулятор: калькуляторы 
путешествие: путешествия 
медицина: медицина 
здоровье: здоровье 
недвижимость: недвижимость 
подкаста: подкасты 
видео: видео 
смотреть: смотреть 
сервис: сервиса сервис сервисы 
расчет: расчеты 
закладка: закладки 
письмо: письма 
оставаться: осталось оставайтесь 
деньги: деньгами деньги денег 
поток: потоки 
инвестразбор: инвестразборы 
group: group 
plc: plc 
hhr: hhr 
купить: купили купить 
партнерство: партнерстве 
тинькофф: тинькофф 
котировка: котировках котировки 
обновляться: обновляются 
минута: минут 
начало: начале 
январь: января 
год: лет году года 
московский: московской 
биржа: бирже биржу 
обновлять: обновили 
свой: свои своем своей своих 
четырехмесячный: четырехмесячные 
минимум: минимумы 
фон: фоне 
мрачный: мрачных 
рыночный: рыночных 
прогноз: прогнозов прогноз 
связанный: связанных 
низкий: низкой 
активность: активностью 
работодатель: работодателям работодателей работодателю 
финансовый: финансовые 
результат: результаты 
мочь: могут 
сильно: сильно 
пострадать: пострадать 
конец: конце 
российский: российский российских российскую 
компания: компании компаниях компания 
повсеместно: повсеместно 
наблюдаться: наблюдалась 
смена: смена смены 
главный: главной 
глава: главе 
угол: угла 
подбор: подбору подбор 
новый: новая новых новый 
сотрудник: сотрудников 
удержание: удержание 
кадр: кадров 
особенно: особенно 
остро: остро 
этот: эта 
проблема: проблем проблемы проблема проблеме 
стоять: стоит 
крупный: крупных крупные крупный 
такой: такие такое таким 
подход: подходом 
данный: данных данным 
рбк: рбк 
пользоваться: пользовались пользоваться 
рф: рф 
никита: никита 
компанищенко: компанищенко 
частный: частный 
инвестор: инвесторам инвестор инвесторов 
профиль: профиль 
автор: автора 
источник: источник 
мосбиржа: мосбирже мосбиржа 
hhru: hhru 
персонал: персонала 
россия: россии 
страна: странах 
снг: снг 
средний: средней 
ежемесячный: ежемесячной 
аудитория: аудиторией 
млн: млн 
уникальный: уникальных 
пользователь: пользователей 
сайт: сайте сайт сайтом 
мировой: мировом 
профильный: профильном 
рейтинг: рейтинге 
занимать: занимает 
второй: второе 
место: место мест 
категория: категории 
трудоустройство: трудоустройство 
уступать: уступая 
indeed: indeed 
основной: основные основная основной основных 
доход: доходы доход 
приносить: приносит 
собственный: собственная 
который: который которая которые которой 
предлагать: предлагает 
потенциальный: потенциальным 
рекрут: рекрутам 
платный: платный 
доступ: доступ 
обширный: обширной 
база: базе 
резюме: резюме 
портал: порталу 
объявление: объявлений объявления объявлению 
вакансия: вакансиях вакансии 
кроме: кроме 
также: также 
пытаться: пытается 
интегрировать: интегрировать 
дополнительный: дополнительным дополнительных дополнительные 
услуга: услуг услуги 
продукт: продукты 
повышать: повысить 
эффективность: эффективность 
процесс: процесса 
найм: найма 
эмитент: эмитенту эмитент эмитента 
делить: делит 
три: тремя трех 
способ: способами 
вид: видам 
группа: группы группа группе группу 
состоять: состоит 
четыре: четырех 
сегмент: сегментов 
клиент: клиенты клиентов клиентам 
покупать: покупать покупают 
право: право 
размещать: размещать размещали разместить 
определенный: определенное 
количество: количество 
некий: некий 
срок: срок 
предоставлять: предоставляет 
основа: основе 
подписка: подписки подпиской подписка 
день: дня дней 
двенадцать: двенадцати 
месяц: месяцев 
комплексный: комплексная комплексные 
открывать: открывает 
разрешать: разрешает 
медийный: медийная 
реклама: реклама 
многое: многое 
другой: другое других другие 
тип: типу 
одновременно: одновременно 
небольшой: небольшие 
проходить: проходят прошедшие 
первый: первую 
обычно: обычно 
относиться: относится 
малый: малый 
штат: штатом 
менее: менее 
работник: работник работников 
прочее: прочее 
основное: основном 
иностранный: иностранных иностранным иностранные 
остальной: остальных остальные 
географический: географическому 
принцип: принципу 
выделять: выделить выделяет 
москва: москве москва 
регион: регионы 
сюда: сюда 
относить: относит 
структура: структура 
продажа: продажи продаж 
изменение: изменение 
география: географии 
акционер: акционеры акционеров акционер акционерам 
объявлять: объявила 
инвестиционный: инвестиционный 
фонд: фонд 
elbrus: elbrus 
продавать: продал продать 
большой: большую 
часть: часть 
становиться: стать стали стала 
обладатель: обладателем 
бумага: бумагам бумаги бумаг 
начинать: начала 
пакет: пакет 
около: около 
рекрутинговый: рекрутингового 
вероятно: вероятно 
холдинг: холдинг 
основывать: основанный 
иван: иваном 
таврин: тавриным 
специализироваться: специализируется 
ранний: ранних 
сектор: сектор 
высокий: высокой высоких 
технология: технологий 
медиа: медиа 
телекоммуникация: телекоммуникаций 
например: например 
участвовать: участвовала 
ozon: ozon 
публичный: публичными 
качество: качестве 
нынешний: нынешних 
актив: активов 
два: две 
октябрь: октябре 
млрд: млрд 
доллар: долларов 
развлекательный: развлекательным развлекательный 
управлять: управляет 
детский: детским 
телеканал: телеканалом 
бывший: бывший 
disney: disney 
channel: channel 
музыкальный: музыкальным 
единственный: единственная 
успешно: успешно 
проводить: провела 
листинг: листинг 
spac: spac 
американский: американской 
nasdaq: nasdaq 
вести: ведут 
операционный: операционную 
деятельность: деятельность 
выходить: выйти выходят 
привлечение: привлечения 
разбираться: разбираемся 
последний: последней 
мода: моде 
goldman: goldman 
sachs: sachs 
делать: делать 
хороший: лучшие лучшее 
неделя: неделю 
ваш: вашей 
почта: почте 
каждый: каждый 
понедельник: понедельник 
бесплатно: бесплатно 
подписываться: подписаться подписывайтесь 
рост: роста рост 
основный: основного 
собственник: собственника 
позитивно: позитивно 
сказываться: сказалась 
причина: причина 
возможный: возможная 
трансформация: трансформация трансформацию 
новое: нового 
мажоритарий: мажоритария 
активный: активных 
действие: действий 
вопрос: вопросе 
повышение: повышения 
капитализация: капитализации 
будущее: будущем 
создавать: создан 
краткосрочный: краткосрочной 
перспектива: перспективе 
вариант: вариант 
маловероятный: маловероятен 
пока: пока 
планировать: планирует 
развивать: развивать 
независимо: независимо 
менеджмент: менеджмента менеджмент 
изменять: изменит 
взгляд: взгляды 
вероятность: вероятностью 
получать: получат получать получили 
оферта: оферту 
рамка: рамках 
несогласный: несогласные 
смочь: смогут смогло 
текущий: текущий 
переход: переход 
правый: прав 
собственность: собственности 
приводить: приведет 
обязательный: обязательного 
предложение: предложения 
превышать: превышен 
порог: порог 
драйвер: драйвером 
редомициляция: редомициляция 
перерегистрация: перерегистрация 
кипрский: кипрской 
юрисдикция: юрисдикции 
шаг: шаг 
помогать: поможет помочь 
вернуться: вернуться 
выплата: выплату выплат выплате выплатой 
дивиденд: дивиденд дивидендов 
ввиду: ввиду 
уходить: уйдут 
инфраструктурный: инфраструктурных инфраструктурные 
технический: технические 
ограничение: ограничения 
появляться: появились 
западный: западных 
санкция: санкций 
против: против 
нрд: нрд 
находить: найдет 
решение: решения решение 
выплачивать: выплатить 
максимум: максимум 
рубль: рублей 
лежать: лежат 
счет: счет счетах 
пересчет: пересчете 
один: одну 
давать: дает 
размер: размере 
р: р 
соответствовать: соответствует 
дивдоходность: дивдоходности 
динамика: динамика 
дивидендный: дивидендных дивидендная дивидендной 
доходность: доходность 
итог: итоге 
позитивный: позитивная 
новость: новости новость 
должно: должно 
ускорять: ускорить 
корпоративный: корпоративную 
вдобавок: вдобавок 
фокус: фокус 
смещаться: сместится 
сторона: сторону 
прошлое: прошлое 
руководство: руководство 
справляться: справиться 
говорить: говорить 
среднесрочный: среднесрочной 
нужно: нужно 
присматриваться: присмотреться 
быстро: быстро 
восстанавливаться: восстановиться 
цена: цене 
принимать: примет 
правильный: правильные 
касаться: касаются 
наш: нашем 
курс: курсе 
происходить: происходящего 
тэг: тэги 
комментарий: комментарии 
модерация: модерацию 
правило: правилам правила 
журнал: журнала 
мошенник: мошенникам 
понадобиться: понадобились 
справка: справки 
репетитор: репетитор 
полагаться: полагался 
каникулы: каникулы 
платить: платил 
налог: налог налоги 
человек: человеку человек 
инвалидность: инвалидностью 
копить: копить 
балл: баллы 
уведомлять: уведомлять 
белоруссия: белоруссии 
поставлять: поставлять поставить 
товар: товары 
ипать: ип 
молодой: молодой 
хотеть: хочет 
оформлять: оформить 
машина: машину 
какой: какие 
риск: риски 
быть: будут 
сотрудничать: сотрудничают 
сосед: соседи 
заливать: залили 
дверной: дверную 
ручка: ручку 
замок: замок 
клей: клеем 
протест: протест 
ремонт: ремонта 
завещание: завещание 
ребенок: дети детей 
муж: мужа 
имущество: имущество 
стоимость: стоимости 
здание: здание 
баланс: баланс 
рассказывать: расскажите 
багаж: багажом 
возникать: возникали 
поездка: поездках 
косметичка: косметичка 
уход: уход 
чувствительный: чувствительной 
комбинированный: комбинированной 
кожа: кожей 
акна: акне 
последствие: последствия 
покупатель: покупателя 
продавец: продавец 
вносить: внесет 
доля: доли 
сколько: сколько 
вернуть: вернуть 
обучение: обучение 
отрабатывать: отработала 
целевой: целевому 
договор: договор договору 
составлять: составить 
процент: проценты 
популярный: популярное 
посылка: посылка 
застревать: застряла 
таможня: таможне 
стаут: стауты 
гоза: гозе 
ламбик: ламбики 
пить: пить 
крафтовый: крафтовое 
пиво: пиво 
жить: живет 
бали: бали 
зарплата: зарплатой 
въезд: въезда 
сербия: сербию 
россиянин: россиян 
мнение: мнение 
поколение: поколение 
девяностый: девяностых 
лишний: лишнее 
труд: труда 
беспроводный: беспроводные 
колонка: колонки 
удачный: удачных 
модель: моделей 
директор: директор 
розничный: розничной 
сеть: сети 
поволжье: поволжье 
экономист: экономист 
дежурный: дежурный 
электромонтер: электромонтер 
новосибирск: новосибирске 
несколько: несколько 
тратить: тратила 
классный: классные 
впечатление: впечатления 
apple: apple 
watch: watch 
сообщать: сообщить 
проект: проекте 
контакт: контакты 
политика: политика 
конфиденциальность: конфиденциальности 
пользование: пользования 
ао: ао 
банк: банк 
лицензия: лицензия 
