обзор: обзор 
рынок: рынок рынке рынка рынку 
недвижимость: недвижимость недвижимости 
россия: россия россии 
итог: итоги итоге итогам 
прогноз: прогнозы 
год: год годов годы годами году лет года 
анализ: анализе анализ 
динамика: динамики 
цена: ценами цене цены цен ценой ценам цену цена 
квартира: квартиры квартиру квартир квартира 
промой: промо 
дарить: дарит 
акция: акции 
регистрация: регистрацию 
мочь: могу могли могут 
получать: получить получать получили 
учебник: учебник учебникам 
сравнятор: сравнятор 
сообщество: сообщество 
ипотека: ипотеку ипотека ипотек ипотеки ипотекой ипотеке 
кредитный: кредитная 
история: историю история 
тест: тесты 
дневник: дневники дневник 
трата: трат 
налоговый: налоговые налоговую налоговый 
вычет: вычет 
написать: написать 
инвестиция: инвестиции 
бизнес: бизнес бизнеса 
разбор: разборы 
закон: законов 
калькулятор: калькуляторы 
путешествие: путешествия 
медицина: медицина 
здоровье: здоровье 
подкаста: подкасты 
видео: видео 
смотреть: смотреть 
сервис: сервисы 
расчет: расчеты 
закладка: закладки 
письмо: письма 
оставаться: остаются оставайтесь 
деньги: деньгами деньги денег 
поток: потоки 
инвестразбор: инвестразборы 
заканчиваться: закончился 
ждать: ждать ждут жду ждет 
ажиотажный: ажиотажный ажиотажного 
рост: роста рост 
весна: весне весной весны 
столичный: столичное столичные 
становиться: стал стали стало 
падать: падающего падает падать 
мнение: мнению мнение 
аналитик: аналитиков 
стоимость: стоимость стоимости 
жилье: жильё жилье жилья 
продолжать: продолжит продолжат продолжают 
снижаться: снижаться снизилась снижался 
сценарий: сценарию 
один: одни одну одной 
оговорка: оговоркой 
падение: падение 
сильно: сильнее 
огромный: огромный огромного 
пузырь: пузыри пузырь пузыря 
николай: николай 
валюха: валюх 
частный: частный 
инвестор: инвесторы инвестор инвесторов 
профиль: профиль 
автор: автора автор 
курс: курсе курс 
общаться: общаться 
понимать: понимать 
друг: друг друга другом 
бесплатный: бесплатный 
бережно: бережно 
окружающий: окружающими 
часто: чаще 
желать: желаемое желать 
изучать: изучить 
москва: москве москва москвы 
номинально: номинально 
подорожать: подорожало подорожали 
подсчет: подсчетам 
портал: портала 
вторичный: вторичном вторичное 
тысяча: тысяч тысячи 
рубль: рублях рублей рубля рубль 
квадрат: квадрат 
номинальный: номинальные номинальный 
составлять: составил составить 
это: этому это 
ниже: ниже 
потребительский: потребительской 
инфляция: инфляции инфляцией 
вырастать: вырос выросли выросла 
счет: счет счетах 
удачный: удачных 
первый: первых первом 
месяц: месяцы месяц месяцев 
январь: январе января 
апрель: апрель апреля 
дело: дело 
ажиотаж: ажиотаже 
ослабление: ослабления 
санкция: санкций санкции 
прочий: прочего 
выдыхаться: выдохся 
май: мая 
декабрь: декабре декабрем декабрь декабря 
упасть: упала упал упадут упало 
ключевой: ключевое 
комментарий: комментарий комментария комментарии 
ирн: ирн 
прошлый: прошлый 
метр: метр метра 
дешеветь: дешевел 
примерно: примерно 
проблема: проблемы проблема проблеме 
российский: российской 
экономика: экономики 
серьезно: серьезнее 
главное: главное 
фон: фоне 
низкий: низких низкий 
ставка: ставки ставками ставок ставку 
кредит: кредитов кредита кредиту кредитам 
депозит: депозитам 
московский: московской московские московских 
раз: раза 
учитывать: учитывая 
идентичный: идентичную 
реакция: реакцию 
событие: события 
предполагать: предположить 
близкий: ближайшие 
ползти: ползти 
вниз: вниз 
процент: процентов процент проценты 
скорректироваться: скорректируются 
максимум: максимумов 
вернуться: вернутся вернется 
уровень: уровням уровне уровень уровня 
начинать: начали начала 
случаться: случится 
новый: новых 
также: также 
подводить: подвел 
топтаться: топтались 
место: месте мест 
снижение: снижения снижение 
последний: последних последний последние 
восемь: восьми 
приостанавливаться: приостановилось 
причина: причина причинам 
сокращение: сокращение 
объем: объемов объем 
предложение: предложения предложение 
количество: количестве количество 
выставлять: выставленных 
продажа: продажи продаже продажу 
осень: осени 
лот: лоты 
раскупать: раскупили 
снимать: снимают 
сам: сами 
продавец: продавцы продавец продавца 
который: который которые которое 
разочаровываться: разочаровались 
текущий: текущей текущими 
многие: многие 
собственник: собственников собственники 
морально: морально 
готовый: готовы готового 
уступка: уступке уступкам 
уходить: уходит уходят 
хороший: хорошая лучшие лучших хорошие лучшего лучший лучшем 
время: время времен 
несмотря: несмотря 
некоторый: некоторая некоторое 
превышать: превышает 
февраль: февраля 
поэтому: поэтому 
глобально: глобально 
тенденция: тенденции 
меняться: меняются 
слабый: слабый 
спрос: спроса спрос 
избыток: избыток 
давить: давить 
близко: ближе 
активизироваться: активизируется 
вновь: вновь 
пойти: пойдут 
источник: источник 
доходность: доходности доходность 
ноль: ноль нули нуля 
данный: данный данным 
конец: концу 
индекс: индекс 
вторичка: вторички вторичке вторичка вторичку 
показывать: показывает 
сколько: сколько 
аренда: аренда 
плюс: плюс 
вклад: вкладам вклада 
банк: банк банке 
единица: единицы 
мало: мало меньше 
приносить: приносят 
убыток: убыток 
резкий: резкого 
переживать: переживал 
инвестиционный: инвестиционном инвестиционный инвестиционной 
бум: бум 
оценка: оценке 
каждый: каждая 
седьмой: седьмая 
сделка: сделку сделка сделок 
консервативный: консервативные 
поверять: поверили 
пятый: пятая 
поставлять: поставлять поставили поставить 
крест: крест 
сокращаться: сократился 
сходить: сошел 
отрываться: оторвался 
зарплата: зарплатой зарплаты зарплата зарплатам 
среднегодовой: среднегодовая 
медианный: медианная 
увеличиваться: увеличилась увеличился 
среднее: среднем 
данные: данные 
заявка: заявок 
россиянин: россияне россиян 
оформлять: оформили оформить 
результат: результат 
подрастать: подросло 
благодаря: благодаря 
сезонный: сезонному 
фактор: фактору 
самый: самые самый 
активный: активный 
ипотечный: ипотечными ипотечного ипотечном ипотечных 
наверняка: наверняка 
сказываться: сказались 
заявление: заявлений заявления 
чиновник: чиновников 
ноябрь: ноябре 
минфин: минфин минфина 
предлагать: предложил 
продлять: продлили продлять 
льготный: льготной льготная льготную 
программа: программ программы программу 
официально: официально 
середина: середине 
менее: менее 
выгодный: выгодных 
условие: условиях 
подымать: подняли 
просто: просто 
запрыгивать: запрыгивать 
вагон: вагон 
поезд: поезда 
изменяться: изменятся 
рекордный: рекордным 
сравнение: сравнению сравнение 
млрд: млрд 
полный: полный 
ничтожный: ничтожного 
квартал: квартале 
размер: размер 
декабрьский: декабрьский 
средний: средний 
млн: млн 
получаться: получилось получится 
большой: большом 
долевой: долевого долевое 
строительство: строительство 
такой: такая такого такое таких такую 
значительный: значительная 
часть: часть 
кредитование: кредитования 
застройщик: застройщик застройщиков застройщики застройщиком застройщика 
рамка: рамках 
строитель: строители 
продавать: продают продавать продать 
околонулевой: околонулевой 
завышать: завышают 
искусственно: искусственно 
разгонять: разгоняет разгонят 
увеличивать: увеличивает 
цб: цб 
ограничивать: ограничит 
выдача: выдачу 
аргумент: аргумент 
польза: пользу 
охлаждение: охлаждения 
интересно: интересно 
период: периода 
июнь: июнь 
активно: активно 
внедрять: внедряли 
половина: половине 
возможно: возможно 
скидка: скидках скидку скидки 
делать: делать делают 
описывать: описал 
пример: примеру примере 
первичный: первичном 
поддерживать: поддерживает 
государство: государства 
субсидировать: субсидированную субсидируемые 
долго: долго 
поползти: поползли 
достигать: достигать 
разморозиться: разморозился 
корректировка: корректировка корректировке 
беспрецедентный: беспрецедентной 
глубина: глубине 
торг: торга 
долгий: долгое 
душа: душу 
снижать: снижать снижают 
оставлять: оставляют 
активизация: активизация 
завершение: завершении 
вряд: вряд 
переламывать: переломит 
общий: общий 
тренд: тренд 
пока: пока 
новостройка: новостройки 
высоко: выше 
сопоставимый: сопоставимого 
качество: качества 
новость: новости 
касаться: касаются касается коснется 
наш: нашем наших 
подписываться: подписаться подписывайтесь 
происходить: происходящего 
тэг: тэги 
актуальный: актуальное 
фотография: фотография 
обложка: обложке 
vadim: vadim 
zakharishchev: zakharishchev 
shutterstock: shutterstock 
проходить: проходят 
модерация: модерацию 
правило: правилам правила 
журнал: журнала 
sophisticated: sophisticated 
one: one 
отредактировать: отредактировано 
доллар: доллар доллару долларах 
точно: точно 
зависеть: зависит 
насколько: насколько 
печатный: печатный 
станок: станок 
объявление: объявлении объявлениях 
рыночный: рыночная 
минимум: минимум 
два: двум 
реальный: реальных 
практический: практические 
продаваться: продаются 
субсидирование: субсидированием 
тот: те теми ту 
попробовать: попробуйте 
годовой: годовых 
считать: считать считаете 
отвечать: ответить 
герой: герой 
отдично: отдично 
знать: знаю 
работать: работают работает 
брать: берут 
потенциальный: потенциальных 
сосед: соседей соседи 
попрощаться: попрощался 
мы: нами 
петров: петров 
давать: давай 
дождаться: дождетесь дождусь 
александр: александр 
значит: значит 
определенный: определенный 
момент: момент 
начинаться: начнется 
среди: среди 
ждунов: ждунов 
упускать: упустил 
стоять: стоит 
обратно: обратно 
хотя: хотя 
иначе: иначе 
карман: карману 
предпосылка: предпосылок 
далеко: дальше 
боковик: боковик 
ivan: ivan 
petrov: petrov 
бояться: боюсь 
уважаемый: уважаемый 
аноним: аноним 
ага: ага 
пара: пару 
лимонов: лимонов 
стоить: стоило 
подешеветь: подешевело подешевела 
дмитрий: дмитрий 
никонов: никонов 
человек: люди человеку человек 
делиться: делятся 
вид: видом вида 
лопнуть: лопнет 
ита: ит 
другой: другие 
бетонный: бетонный 
roman: roman 
еще: ещё 
идеалист: идеалисты 
окончательно: окончательно 
америка: америка 
хана: хана 
классик: классик 
второй: вторым 
вторжение: вторжением 
ирак: ирак 
говорить: говорил говорю говорить 
бумажка: бумажка 
биткоин: биткоина 
фондовый: фондовый фондового 
чистый: чистые 
эстет: эстеты 
li: li 
обвалиться: обвалился 
пора: пора 
закупаться: закупаться 
котлета: котлету 
сначала: сначала 
ваш: вашу 
уверять: уверяю 
никто: никто 
лишь: лишь 
хотелка: хотелки 
собираться: собираюсь 
она: её 
купить: купленное купила купить 
жить: живут жить живет 
исключительно: исключительно 
понимание: понимания 
порядок: порядка 
минута: минуты 
метро: метро 
нормальный: нормальной нормальная 
наверное: наверное 
толком: толком 
кроме: кроме 
релокант: релоканты 
распродавать: распродавали 
паника: панике 
бесценок: бесценок 
очень: очень 
упирать: уперты 
неделя: неделю 
назад: назад 
закрывать: закрыл 
договор: договор договору 
цессия: цессии 
очередной: очередному 
пиковский: пиковскому 
человейник: человейнику 
дисконт: дисконт 
аж: аж 
какой: какие 
жалкий: жалкие 
устраивать: устроило 
мой: моему 
неплохо: неплохо 
улавливать: улавливаю 
сарказм: сарказм 
напрямую: напрямую 
вместо: вместо 
покупать: покупать 
ежемесячный: ежемесячный 
платеж: платежей платеж 
случай: случае 
гораздо: гораздо 
покупаться: покупается 
причем: причем 
деноминация: деноминации деноминация 
helg: helg 
svart: svart 
март: марта 
крым: крым крыму 
принадлежать: принадлежал принадлежит 
учить: учить 
украинский: украинским 
вроде: вроде 
утверждать: утверждал 
действительно: действительно 
кристина: кристина 
пэн: пэн 
июль: июля 
определять: определили 
юрий: юрий 
рузавин: рузавин 
ответ: ответ 
вопрос: вопрос 
крыться: кроется 
расположение: расположении 
слишком: слишком 
известный: известная 
локация: локация 
печально: печально 
недалеко: недалеко 
аналитика: аналитику 
остальной: остальной остальные 
население: населению 
предел: пределами 
например: например 
чувство: чувство 
расти: расти 
снова: снова 
vladimir: vladimir 
voronkov: voronkov 
офигеть: офигеть 
напряжение: напряжение 
юг: юге 
рф: рф 
кажется: кажется 
развитие: развитие 
военный: военной 
обстановка: обстановка обстановки 
иной: иную 
сторона: сторону 
влиять: влиять 
явсегда: явсегда 
специфический: специфической 
спать: спать 
миллион: миллионом 
просыпаться: проснулся 
копейка: копейки 
рука: руках 
изменение: изменения 
обратный: обратную 
общеснгшное: общеснгшное 
скажем: скажем 
ситуация: ситуации ситуация 
масштабный: масштабных 
боевой: боевых 
действие: действий 
территория: территории 
гражданский: гражданской 
война: войны 
таджикистан: таджикистане 
должный: должны 
следовать: следовать 
белгород: белгороде 
неадекватный: неадекватные 
переуступка: переуступки 
искать: искать 
появляться: появляется появляются 
г: г 
правда: правда 
редко: редко 
быстро: быстро 
поймать: поймать 
нехетти: нехетти 
грин: грин 
хотеть: хотела хочет хочу 
посмотреть: посмотреть 
дкп: дкп 
структура: структуры 
далее: далее 
список: списку 
риск: рисков риски 
podzhok: podzhok 
pukanoff: pukanoff 
никуда: никуда 
смысл: смысле 
спустя: спустя 
покупка: покупки 
правый: правы 
затрагивать: затрагивает 
долг: долг 
число: числе 
погуглить: погуглите 
народ: народ 
поверить: поверить 
идти: идти 
вначале: вначале 
путать: путать 
кто: кого 
везде: везде 
убираться: убираются 
писать: пишите пишете 
ошибка: ошибка 
воу: воу 
откуда: откуда 
никита: никита 
сергеич: сергеич 
передавать: передавал 
состав: состав 
усср: усср 
оплата: оплате 
наличные: наличными 
ai: ai 
упускаться: упускается 
маржинальность: маржинальность 
объект: объектов 
след: след 
усложняться: усложнившейся 
логистика: логистикой 
иностранный: иностранных иностранным 
материал: материалов 
процесс: процесс 
свое: свое 
очередь: очередь 
сокращать: сократит 
среднесрочный: среднесрочной 
перспектива: перспективе 
приводить: приведет 
увеличение: увеличению 
возможный: возможна 
краткосрочный: краткосрочной 
учет: учете 
столиный: столиный 
регион: регион 
меньший: меньшей 
степень: степени 
tanya: tanya 
dobry: dobry 
весь: вся 
заголовок: заголовке 
иван: иван 
книжка: книжка 
финансовый: финансовые 
суть: сути 
надуваться: надуваться 
разный: разных 
класс: классах 
актив: активов 
идея: идея 
профессионал: профессионалам 
сложно: сложно 
предсказывать: предсказать 
чпокнуть: чпокнет 
сдуваться: сдуваться 
обыватель: обывателей 
кругозор: кругозора 
полезно: полезно 
почитать: почитать 
позволять: позволит 
дешево: дешевле 
угадайка: угадайка 
увы: увы 
эксперт: эксперта 
придуманый: придуманую 
информация: информацию 
убирать: убирают 
тело: теле 
удобно: удобно 
молчать: молчу 
никакой: никаких 
вспомнить: вспомним 
разговор: разговор 
вместе: вместе 
посмеяться: посмеемся 
глупость: глупостями 
мошенник: мошенникам 
понадобиться: понадобились 
справка: справки 
репетитор: репетитор 
полагаться: полагался 
каникулы: каникулы 
платить: платил 
налог: налог налоги 
инвалидность: инвалидностью 
копить: копить 
балл: баллы 
уведомлять: уведомлять 
белоруссия: белоруссии 
работник: работник 
товар: товары 
работодатель: работодателю 
ипать: ип 
молодой: молодой 
машина: машину 
быть: будут 
сотрудничать: сотрудничают 
заливать: залили 
дверной: дверную 
ручка: ручку 
замок: замок 
клей: клеем 
протест: протест 
ремонт: ремонта 
завещание: завещание 
ребенок: дети детей 
муж: мужа 
имущество: имущество 
здание: здание 
баланс: баланс 
рассказывать: расскажите 
багаж: багажом 
возникать: возникали 
поездка: поездках 
косметичка: косметичка 
уход: уход 
чувствительный: чувствительной 
комбинированный: комбинированной 
кожа: кожей 
акна: акне 
последствие: последствия 
покупатель: покупателя 
вносить: внесет 
доля: доли 
вернуть: вернуть 
обучение: обучение 
отрабатывать: отработала 
срок: срок 
целевой: целевому 
популярный: популярное 
посылка: посылка 
застревать: застряла 
таможня: таможне 
стаут: стауты 
гоза: гозе 
ламбик: ламбики 
пить: пить 
крафтовый: крафтовое 
пиво: пиво 
бали: бали 
въезд: въезда 
сербия: сербию 
поколение: поколение 
девяностый: девяностых 
лишний: лишнее 
труд: труда 
беспроводный: беспроводные 
колонка: колонки 
модель: моделей 
директор: директор 
розничный: розничной 
сеть: сети 
поволжье: поволжье 
экономист: экономист 
дежурный: дежурный 
электромонтер: электромонтер 
новосибирск: новосибирске 
несколько: несколько 
тратить: тратила 
классный: классные 
впечатление: впечатления 
apple: apple 
watch: watch 
вакансия: вакансии 
сообщать: сообщить 
проект: проекте 
контакт: контакты 
политика: политика 
конфиденциальность: конфиденциальности 
пользование: пользования 
сайт: сайтом 
выходить: выйти 
ао: ао 
лицензия: лицензия 
