интерфакс: интерфакс 
сервер: сервер 
раскрытие: раскрытия 
информация: информации 
центр: центр 
корпоративный: корпоративной 
включать: включите 
cookie: cookie 
javascript: javascript 
браузер: браузере браузера браузеров 
продолжение: продолжения 
работа: работы 
сайт: сайта сайтом 
ваш: вашем 
выключать: выключена 
передача: передача 
отключать: отключено 
выполнение: выполнение 
код: кода 
необходимый: необходимы 
обеспечение: обеспечения 
корректный: корректного 
функционирование: функционирования 
пожалуйста: пожалуйста 
изменять: измените 
соответствующий: соответствующие 
настройка: настроек настройки 
перезагружать: перезагрузите 
страница: страницу страницах 
подробно: подробнее 
изменение: изменении 
мочь: можете 
ознакомляться: ознакомиться 
поддержка: поддержки 
mozilla: mozilla 
firefox: firefox 
google: google 
chrome: chrome 
