правило: правила правилам правил правилами 
пользование: пользования 
сайт: сайту сайт сайтом сайте сайта 
промой: промо 
бесплатный: бесплатная 
кредитка: кредитка 
промокод: промокоду 
fgo: fgo 
давать: даете давайте 
учебник: учебник 
сравнятор: сравнятор 
сообщество: сообществе сообщество 
ипотека: ипотека 
кредитный: кредитная 
история: историю история истории 
тест: тесты 
дневник: дневники дневник 
трата: трат 
налоговый: налоговые налоговую налоговый 
вычет: вычет 
написать: написать 
инвестиция: инвестиции 
бизнес: бизнес бизнеса 
разбор: разборы 
закон: законов закону 
калькулятор: калькуляторы 
путешествие: путешествия 
медицина: медицина 
здоровье: здоровье 
недвижимость: недвижимость 
подкаста: подкасты 
видео: видео 
смотреть: смотреть 
сервис: сервисы 
расчет: расчеты 
закладка: закладки 
письмо: письма 
оставаться: оставайтесь оставаться 
деньги: деньгами деньги денег 
поток: потоки 
настоящий: настоящие настоящим настоящих 
определять: определяют 
порядок: порядка порядок порядке 
доступ: доступ доступа 
тинькофф: тинькофф 
журнал: журнал журнала журналом 
пользователь: пользователем пользователями пользователь пользователя пользователю пользователей 
представлять: представляют 
себя: собой 
публичный: публичную публичный 
оферта: оферту 
редакция: редакция редакции редакцией 
банк: банк 
соответствие: соответствии 
ст: ст 
гражданский: гражданского 
кодекс: кодекса 
рф: рф 
получать: получим получать получая получили получено 
использовать: используя использовать использованные 
функция: функции функциями функций 
выражать: выражаете 
подтверждать: подтверждает подтверждаете 
свое: свое 
согласие: согласия согласие 
данные: данными 
читать: читая 
соглашаться: соглашается соглашаетесь 
наш: нашим наши наших нашими 
условие: условиями условий 
именно: именно 
регистрация: регистрации регистрация 
становиться: становятся стать 
необходимо: необходимо 
проходить: пройти 
процедура: процедуру 
авторизация: авторизацию авторизации 
номер: номеру 
телефон: телефона телефон 
адрес: адреса адресу адрес 
электронный: электронной 
почта: почты 
учетный: учетной учетную 
запись: записи запись 
социальный: социальную социальные 
сеть: сети сеть 
посетитель: посетителя посетитель посетителей 
автоматически: автоматически 
создавать: создавать создает 
путем: путем 
импортирование: импортирования 
зависимость: зависимости 
способ: способа 
имя: имени имя 
фотография: фотографии фотографию 
оставлять: оставляет оставлять оставляете 
комментарий: комментарий комментария комментарии комментариях комментариев 
участвовать: участвовать 
дискуссия: дискуссиях 
нужно: нужно 
зайти: зайти 
личный: личный личному личную 
кабинет: кабинет 
зарегистрироваться: зарегистрируетесь 
ваш: вашего ваш ваши ваше вашу 
почитать: почту 
размещение: размещение 
информация: информации информацию 
число: числе 
ответ: ответов 
вопрос: вопросы вопрос вопросов 
анкета: анкет 
собственный: собственных 
текст: текстов текст 
специальный: специальной специального специальных 
форма: форме 
контент: контенте контента контент 
размещать: размещая размещать 
гарантировать: гарантирует 
обладать: обладает 
все: всеми 
необходимый: необходимыми необходимое 
это: этим это 
право: правами права право 
также: также 
содержать: содержит содержащие 
запрещать: запрещены запрещенных 
заимствование: заимствований 
объект: объекты объект 
исключительный: исключительные 
интеллектуальный: интеллектуальной 
собственность: собственности 
использование: использования использование использовании 
изображение: изображения 
гражданин: гражданина 
принадлежать: принадлежат 
законодательство: законодательством законодательство законодательству 
разрешение: разрешению разрешения разрешение 
обладатель: обладателя 
правый: прав 
данный: данный 
нести: несет несем несете 
ответственность: ответственность 
любой: любую любые любых 
который: которую которая которые который 
загружать: загружать загружает 
иной: иной иные иным 
образ: образом 
доводить: доводит 
всеобщий: всеобщего 
сведение: сведения 
свой: своей свои своем своим своих 
самый: самым 
предоставлять: предоставляет предоставлять 
выплата: выплаты 
вознаграждение: вознаграждения 
безвозмездный: безвозмездную 
лицензия: лицензию лицензия 
воспроизведение: воспроизведение 
распространение: распространение 
показ: показ 
переработка: переработку 
изменение: изменение изменениями 
редактирование: редактирование 
опубликование: опубликование 
перевод: перевод 
включение: включение 
другой: другие других другими другого 
материал: материалы материалов 
доведение: доведение 
ограничение: ограничения 
территория: территории 
срок: срок срока 
указание: указания 
автор: автора автором 
мочь: можете можем могут 
комментировать: комментировать 
статья: статьи 
рассказывать: расскажите рассказывать 
отвечать: отвечать 
нарушать: нарушают нарушающие нарушающий нарушаете нарушены 
чужой: чужих чужое чужие 
авторский: авторских авторское 
должный: должен должны 
должно: должно 
публикация: публикация публикацию 
оскорблять: оскорблять оскорбить 
чувство: чувства 
верующий: верующих 
разжигать: разжечь 
вражда: вражду 
подумать: подумайте 
дважды: дважды 
опубликовывать: опубликовать 
приводить: приведем 
стандарт: стандартам 
добавлять: добавим 
заголовок: заголовок 
немного: немного 
отредактировать: отредактируем 
сам: сами 
решать: решить решаете решили 
аноним: анонимом 
ссылаться: ссылаться 
опыт: опыт опытом 
он: нему 
остальной: остальных остальные 
умолчание: умолчанию 
иметься: имеются 
соответствующий: соответствующими соответствующие 
правообладатель: правообладателя правообладателем 
являться: являются является 
иметь: имеющими имеет 
передавать: переданными передавать 
публиковать: публикуемый публиковать публикуемого 
совершение: совершение 
такой: таких 
действие: действия действиям действий 
приобретать: приобретенными 
российский: российской 
федерация: федерации 
писать: писать пишете пишите 
делиться: делитесь 
быть: будут будьте 
готовый: готовы 
то: тому 
увидеть: увидят 
читатель: читатели читателей 
повод: повод 
дело: делу 
оскорбление: оскорблений оскорбления 
повторять: повторим 
отправлять: отправляете 
заверять: заверяете 
обязываться: обязуется 
соблюдать: соблюдать 
следующий: следующие 
отношение: отношении отношениях 
товарный: товарных 
знак: знаков 
сцена: сцен сцены 
насилие: насилия 
связывать: связанной 
смерть: смертью 
травма: травмами 
жестокость: жестокостью 
взрослый: взрослых 
порнографический: порнографического 
характер: характера 
призыв: призывы 
противоправный: противоправным 
преследование: преследования 
сексуальный: сексуальные 
домогательство: домогательства 
угроза: угрозы 
запугивание: запугивания 
рекламный: рекламные 
спам: спам 
расценивать: расценены 
третий: третьих 
лицо: лицами лиц лицо лица 
порнография: порнографию 
призывать: призывать 
совершать: совершать 
преступление: преступления 
домогаться: домогаться 
реклама: реклама 
контролировать: контролировать 
весь: весь 
брать: брать 
модерироваться: модерируется 
постоянный: постоянной 
основа: основе 
удалять: удалить удалять 
отслеживать: отслеживать 
противоречить: противоречит 
делать: делать 
регистрироваться: регистрироваться 
качество: качестве 
вместо: вместо 
аккаунт: аккаунты аккаунт 
регистрировать: регистрировать 
группа: группу 
юридический: юридической юридических юридическое 
фальшивый: фальшивые 
фирма: фирму 
человек: человеку человека человек 
ложный: ложные 
противозаконный: противозаконную 
донимать: донимать 
массовый: массовыми массовые 
рассылка: рассылками рассылки 
вредить: вредить 
работа: работе 
собирать: собирать 
помощь: помощи 
программа: программ 
искажать: искажать 
возраст: возрасте 
организация: организациями 
хранить: хранить 
распространять: распространять 
соответствовать: соответствует 
осуществлять: осуществлять 
сообщение: сообщений 
программный: программное 
обеспечение: обеспечение 
направлять: направленные 
нарушение: нарушение 
нормальный: нормального 
функционирование: функционирования 
автоматизированный: автоматизированные 
скрипт: скрипты 
сбор: сбора 
взаимодействие: взаимодействия 
мнение: мнению мнение 
нежелательный: нежелательными 
цель: целям 
создание: создания 
ущемлять: ущемляют 
интерес: интересы 
заключительный: заключительные 
положение: положения положений 
составлять: составить составляют 
соглашение: соглашение 
относительно: относительно 
договор: договор договора договору 
вы: вами 
регулироваться: регулируются 
возникать: возникали возникнут 
спор: споры споров 
постараться: постараемся 
переговоры: переговорами переговоров 
пойти: пойдем 
суд: суд 
либо: либо 
арбитражный: арбитражный 
москва: москве москвы 
хорошевский: хорошевский 
районный: районный 
толковаться: толкуются 
случай: случае 
возникновение: возникновения 
разногласие: разногласий 
связанный: связанных 
исполнение: исполнением 
администрация: администрация 
прикладывать: приложат 
усилие: усилия 
проведение: проведения 
они: ними 
разрешать: разрешены 
подлежать: подлежат 
устанавливать: установленном 
действующий: действующим 
сторона: стороны 
обращаться: обращаются 
г: г 
индивидуальный: индивидуальных 
предприниматель: предпринимателей 
физический: физических 
вступать: вступают 
сила: силы силу 
момент: момента моментом 
присоединение: присоединения 
определяться: определяется 
начинать: начала 
действовать: действуют действовать 
течение: течение 
неопределенный: неопределенного 
обязательный: обязательными 
поделиться: поделиться 
причина: причинам 
один: одно 
несколько: несколько 
признавать: признаны 
недействительный: недействительными 
оказывать: оказывает 
влияние: влияния 
действительность: действительность 
применимость: применимость 
вправе: вправе 
изменять: изменять 
время: время времени 
продолжать: продолжая 
пользоваться: пользоваться 
выполнение: выполнение 
связываться: свяжитесь 
пункт: пункты 
переставать: перестают 
мошенник: мошенникам 
понадобиться: понадобились 
справка: справки 
репетитор: репетитор 
полагаться: полагался 
каникулы: каникулы 
платить: платил 
налог: налог налоги 
инвалидность: инвалидностью 
копить: копить 
покупать: покупать 
балл: баллы 
уведомлять: уведомлять 
счет: счет счетах 
белоруссия: белоруссии 
работник: работник 
поставлять: поставлять поставить 
товар: товары 
работодатель: работодателю 
ипать: ип 
молодой: молодой 
хотеть: хочет 
оформлять: оформить 
машина: машину 
какой: какие 
риск: риски 
сотрудничать: сотрудничают 
иностранный: иностранным 
сосед: соседи 
заливать: залили 
дверной: дверную 
ручка: ручку 
замок: замок 
клей: клеем 
протест: протест 
ремонт: ремонта 
завещание: завещание 
ребенок: дети детей 
муж: мужа 
имущество: имущество 
стоимость: стоимости 
здание: здание 
баланс: баланс 
проблема: проблемы проблеме 
багаж: багажом 
поездка: поездках 
косметичка: косметичка 
уход: уход 
чувствительный: чувствительной 
комбинированный: комбинированной 
кожа: кожей 
акна: акне 
последствие: последствия 
покупатель: покупателя 
продавец: продавец 
вносить: внесет 
доля: доли 
сколько: сколько 
вернуть: вернуть 
обучение: обучение 
отрабатывать: отработала 
целевой: целевому 
процент: проценты 
популярный: популярное 
неделя: неделю 
посылка: посылка 
застревать: застряла 
таможня: таможне 
стаут: стауты 
гоза: гозе 
ламбик: ламбики 
место: мест 
пить: пить 
крафтовый: крафтовое 
пиво: пиво 
жить: живет 
бали: бали 
зарплата: зарплатой 
въезд: въезда 
сербия: сербию 
россиянин: россиян 
год: лет году 
поколение: поколение 
девяностый: девяностых 
лишний: лишнее 
рынок: рынке 
труд: труда 
хороший: лучшие 
беспроводный: беспроводные 
колонка: колонки 
удачный: удачных 
модель: моделей 
директор: директор 
розничный: розничной 
поволжье: поволжье 
экономист: экономист 
дежурный: дежурный 
электромонтер: электромонтер 
новосибирск: новосибирске 
тратить: тратила 
классный: классные 
впечатление: впечатления 
apple: apple 
watch: watch 
вакансия: вакансии 
сообщать: сообщить 
проект: проекте 
контакт: контакты 
политика: политика 
конфиденциальность: конфиденциальности 
выходить: выйти 
ао: ао 
