ценный: ценные ценный ценную ценная ценных ценное ценными 
редкий: редкий редкая редкими редкой редких редкого редкие 
монета: монету монетами монетам монета монеты монет монете монетах 
россия: россии 
сколько: сколько 
стоять: стоят стоит 
список: список 
который: который которые которых которого которую которое 
продавать: продал продать продавать продана продадите продают продан 
дорого: дорого 
промой: промо 
дарить: дарит 
акция: акции 
регистрация: регистрацию 
мочь: могу могут мог 
получать: получить получать получили 
учебник: учебник 
сравнятор: сравнятор 
сообщество: сообщество 
ипотека: ипотека 
кредитный: кредитная 
история: история 
тест: тесты 
дневник: дневники дневник 
трата: трат 
налоговый: налоговые налоговую налоговый 
вычет: вычет 
написать: написать 
инвестиция: инвестиции 
бизнес: бизнес бизнеса 
разбор: разборы 
закон: законов 
калькулятор: калькуляторы 
путешествие: путешествия 
медицина: медицина 
здоровье: здоровье 
недвижимость: недвижимость 
подкаста: подкасты 
видео: видео 
смотреть: смотреть смотрим 
сервис: сервисы 
расчет: расчеты 
закладка: закладки 
письмо: письма 
оставаться: осталось оставайтесь 
деньги: деньгами деньги денег 
поток: потоки 
ваш: вашу вашему вашем ваша 
кошелек: кошелек кошелькам кошельке 
виктор: виктор 
тюрин: тюрин 
коллекционировать: коллекционирую коллекционирует 
многие: многие 
повседневный: повседневном 
оборот: обороте 
намного: намного 
дорогой: дорогой дорогие дороже 
номинал: номиналов номинал номиналом номиналу номинала 
цениться: ценятся 
среди: среди 
коллекционер: коллекционера коллекционер коллекционеры коллекционерам коллекционеров 
такой: такая такого таким такое таких такие такую 
рассказывать: расскажу расскажите 
научаться: научиться 
находить: нашла найти находить найдете нашел 
какой: каким какие какому каком 
бывать: бывает бывают 
чеканить: чеканит чеканить чеканят 
центральный: центрального центральный 
банк: банк банке банки 
регулярный: регулярной регулярными регулярные регулярных регулярным 
памятный: памятными памятные памятной памятных 
юбилейный: юбилейных юбилейную юбилейные юбилейной юбилейным 
копейка: копейки копейку копейками копейке копеек 
рубль: рубли рублей рубля рубль 
хотя: хотя 
встречать: встречал встретить 
касса: кассе 
банка: банка банку 
например: например 
снимать: снимаете 
счет: счет счета счетах 
лежать: лежало 
р: р 
выдавать: выдадут 
монетка: монетки монетка 
год: год годы году годам лет года годом годах 
центробанк: центробанк центробанка 
выпускать: выпущены выпускать выпущено выпущенные выпустили выпускают выпустил выпускали выпущенная выпущенных выпускает 
высоко: выше 
чеканка: чеканка чеканки чеканку 
прекращать: прекратили 
являться: являются 
законный: законным 
платежный: платежным 
средство: средством 
обычный: обычных обычные обычный 
случай: случаю 
разный: разных разные 
исторический: исторических 
дата: дат дате 
целый: целые целых 
серия: серию серии серия 
посвящать: посвященные 
определенный: определенного определенному 
событие: событию 
тема: теме 
день: дня день 
рождение: рождения 
пушкин: пушкина 
российский: российской российского российских российские 
футбол: футбола 
флот: флота 
некоторые: некоторым некоторые некоторых 
небольшой: небольшими небольшим небольшой небольшое небольших небольшом 
тираж: тираж тиражом тираже тиражи тиражами 
поэтому: поэтому 
практически: практически 
невозможно: невозможно 
большинство: большинство 
нетрудно: нетрудно 
разновидность: разновидность разновидностей 
инвестиционный: инвестиционной инвестиционные 
выполнять: выполнены 
металл: металла металлов 
серебро: серебра 
медь: меди 
золото: золота 
встречаться: встречаются 
купить: купил купила купить 
каждый: каждой каждую каждым каждого каждом каждый 
честь: честь 
олимпийский: олимпийских 
паралимпийский: паралимпийских 
игра: игр 
сочи: сочи 
источник: источник 
зависеть: зависит 
ценность: ценность 
основной: основной 
двигатель: двигатель 
цена: цене цены цен цену цена 
рынок: рынке 
это: этим это 
нумизмат: нумизмат нумизмата нумизматов нумизматы 
важно: важно 
иметь: имеет имеют иметь имею 
готовый: готовы 
платить: платил платить 
формироваться: формируется 
два: двух 
параметр: параметров параметра 
сохранность: сохранностью сохранности 
редкость: редкости редкостью редкость 
понятно: понятно 
сильно: сильно 
повреждать: поврежденная 
изношенный: изношенная 
мало: мало меньше 
кто: кому 
интересный: интересна интересную интересная 
определяться: определяется 
насколько: насколько 
трудно: трудно 
раздобывать: раздобыть 
экземпляр: экземпляр экземпляров экземпляры 
оценивать: оценить оценивают оцениваем 
учитывать: учесть 
выпуск: выпуски выпуска выпуск 
монетный: монетные монетный монетного монетных 
двор: двор дворы дворов двора 
наличие: наличие 
дефект: дефектами дефектов 
брак: брака браков брак браки браками браком 
новый: новые 
обращение: обращение обращения 
поступать: поступают 
указывать: указывают 
лицевой: лицевой 
сторона: стороной стороне 
аверс: аверсе 
внизу: внизу 
неравномерный: неравномерные 
цб: цб 
несколько: несколько 
становиться: становятся станет становится станут станете 
расти: растут растет 
публиковать: публикует 
данные: данные 
количество: количестве количество 
достоверный: достоверную достоверной 
информация: информации информацию 
почему: почему 
мелкий: мелких мелкие 
экономически: экономически 
невыгодный: невыгодна 
себестоимость: себестоимость 
изготовление: изготовления 
часто: часто 
превышать: превышает 
указанный: указанный 
однако: однако 
отчеканивать: отчеканены отчеканенные 
большой: большое большую большой 
часть: часть 
отправлять: отправили отправить 
крым: крым 
рыночный: рыночная 
стоимость: стоимость стоимости 
составлять: составляет составить составляла 
около: около 
вновь: вновь 
чеканиться: чеканились чеканятся 
неожиданно: неожиданно 
появляться: появились появлялись 
вполне: вполне 
вероятно: вероятно 
правый: правой 
лапа: лапой 
орел: орла 
рублевый: рублевых рублевые 
левый: левым 
копыто: копытом 
конь: коня 
георгий: георгия 
победоносец: победоносца победоносец 
копеечный: копеечных копеечная 
особый: особые 
отметка: отметки 
ставить: ставит 
место: место местах мест 
штамповать: штампуют 
наш: нашего нашей 
страна: стране 
московский: московского московский московской 
ммд: ммд 
м: м 
спмд: спмд 
сп: сп 
знак: знаки знаков знака 
рассматривать: рассмотреть 
помощь: помощью 
лупа: лупы 
невооруженный: невооруженным 
глаз: глазом 
одинаковый: одинаковое 
быть: будут буду будете 
петербургский: петербургской 
случайно: случайно 
ошибка: ошибок ошибкой 
непрочеканивать: непрочеканенными 
элемент: элементами 
перевертывать: перевернутой 
оборотный: оборотной 
редко: редко 
раскол: раскол 
штемпель: штемпеля 
заметный: заметен 
полоска: полоска 
нарушение: нарушение 
форма: форме формы 
другой: другие других 
износ: износ 
поворот: поворот 
существовать: существует 
отдельный: отдельное 
направление: направление 
коллекционирование: коллекционировании 
эрроризм: эрроризм 
слово: слова 
error: error 
попадаться: попадаются попалась 
нестандартный: нестандартная 
точно: точно 
откладывать: откладывал откладываю откладываете откладывают отложите отложить откладывать 
побеждать: победить 
выгорание: выгорание 
курс: курс 
тот: те тех 
работать: работает 
уставать: устает 
открытый: открыта 
назначать: назначаете 
сам: самого сами 
начинать: начать начал начала 
учиться: учиться 
приурочивать: приурочены 
юбилей: юбилеям юбилею 
выглядеть: выглядят 
обычно: обычно 
исключение: исключения исключение 
вид: виде вид виду 
очень: очень 
стоить: стоить 
десяток: десяток десятками десятки 
тысяча: тысяч 
определять: определяет определит 
аукцион: аукционах аукцион 
минимум: минимум 
ниже: ниже 
приводить: приведу 
изучать: изучить 
диапазон: диапазон 
специальный: специальных специальную специальный 
этот: эта этих этими 
сайт: сайтах сайты сайт сайтом сайте 
ориентировочный: ориентировочная ориентировочные 
использовать: используют 
просто: просто 
понимание: понимания 
тенденция: тенденции 
реальность: реальности 
покупать: покупать покупают 
дешево: дешевле 
однозначно: однозначно 
присматриваться: присмотреться 
декабрь: декабря 
самый: самые самая самое самый самых 
современный: современной современные 
широкий: широким 
кант: кантом 
спб: спб 
проверять: проверить 
легко: легко 
веточка: веточка 
растительный: растительного 
орнамент: орнамента 
право: правом 
верхний: верхнем 
угол: углу 
частично: частично 
передний: передним 
доставаться: доставшихся достался досталась 
мечта: мечта 
известно: известно 
никакой: никаких 
данный: данных 
продажа: продажи продаже 
также: также 
итоговый: итоговую 
версия: версии 
известный: известны 
штучный: штучные 
знать: знает знала зная знаю 
один: одна одно 
уникальный: уникальные 
товар: товар товары 
вроде: вроде 
последний: последний 
мелькать: мелькала 
конкретный: конкретной конкретному 
сниматься: снимаются 
производство: производства 
то: тому 
человек: людей люди человеку человек 
довольно: довольно 
приглянуться: приглянувшиеся 
итог: итоге 
ранее: ранее 
постепенно: постепенно 
исчезать: исчезают 
коллекционный: коллекционные коллекционная 
степень: степени 
посмотреть: посмотреть 
удобно: удобно 
база: базе 
писать: пишут писали 
планировать: планируют 
январь: января 
серебряный: серебряную 
золотой: золотую 
червонец: червонец 
перечислять: перечислю 
массовый: массовые 
наверняка: наверняка 
видеть: видели 
город: города городе городов городах 
выпускаться: выпускается 
выходить: вышло выйти выходят 
ранний: ранних ранние 
примерно: примерно 
федерация: федерация 
поздний: поздние 
чяп: чяп 
чеченский: чеченской 
республика: республике республики 
автономный: автономному 
округ: округа округу 
пермский: пермскому пермского 
край: края краю 
маленький: маленьким 
воинский: воинской 
слава: славы 
победа: победы 
универсиада: универсиаде 
казань: казани 
всероссийский: всероссийской 
перепись: переписи 
население: населения 
миллион: миллионов 
сдача: сдачу 
реально: реально 
северный: северная 
осетия: осетия 
алания: алания 
неизвестный: неизвестным 
причина: причинам 
вместо: вместо 
рифление: рифлений 
оказываться: оказалось оказались 
сотня: сотен сотни 
выясняться: выяснилось выяснится 
сердцевина: сердцевина 
притягиваться: притягивается 
магнит: магнит 
альберт: альберт 
балтин: балтин 
инвестировать: инвестирует 
особенность: особенность 
вложение: вложений 
приходиться: придется 
долго: долго 
ждать: ждать 
пока: пока 
вырастать: вырастут вырасти 
относиться: относится 
особенно: особенно 
равно: равно 
рекомендовать: рекомендую 
срок: срок 
дорожать: дорожают дорожает 
постоянно: постоянно 
логично: логично 
повторяться: повторится 
число: число 
полностью: полностью 
переходить: переходят 
профессиональный: профессиональным 
оседать: оседают 
домашний: домашних 
копилка: копилку копилках 
теряться: теряется 
меняться: меняется 
первый: первой первые первый 
медленно: медленно 
кривой: кривая 
резко: резко 
идти: идут идет 
вверх: вверх 
ко: ко 
все: всем всё 
малый: малым 
заводить: заведите 
складывать: складывать 
хранить: хранить 
опознавать: опознать 
горсть: горсти 
мелочь: мелочи мелочью мелочь 
выбрасывать: выбрасывайте выбрасывают 
время: время временем 
неизбежно: неизбежно 
отделять: отделить 
бракованный: бракованные 
перспективно: перспективно 
увидеть: увидите увидели 
необычный: необычный необычное 
оформление: оформлении 
цвет: цвете 
показываться: показалось 
вернуть: вернуть вернете 
назад: назад 
непросто: непросто 
высокий: высокая 
запоминать: запомните запомнить 
четыре: четыре 
просматривать: просматривайте 
уральский: уральский 
скупать: скупать 
давать: дать давал 
кинуться: кинулись 
искать: искать ищем 
полгода: полгода 
смог: смог 
настолько: настолько 
правильный: правильную 
главный: главный 
совет: совет 
рука: рукам руки руках 
попадать: попадает 
нужно: нужно 
осматривать: осмотреть 
быстро: быстро 
любой: любой 
привыкать: привыкнете 
делать: делать делает делают 
автоматически: автоматически 
проверка: проверку 
достаточно: достаточно 
пара: пары 
секунда: секунд 
кассир: кассиры кассира 
попросить: попросить попросите 
именно: именно 
они: ними ими 
поменять: поменял поменять 
разменный: разменные 
навстречу: навстречу 
просьба: просьбам 
размен: размена 
продавец: продавцов продавец продавцам 
нужный: нужны нужна 
удовольствие: удовольствием 
обменять: обменяют 
простой: простой 
способ: способ 
куча: кучу 
друг: друзей другом 
мой: моих моему 
опыт: опыту 
второй: второй вторая 
семья: семье 
ваза: ваза 
мешочек: мешочек 
храниться: хранятся 
никто: никто никому 
пользоваться: пользуется 
выгодный: выгодный выгодные 
вариант: вариант 
посредник: посредников 
интернет: интернет интернете 
полно: полно 
возможность: возможностей 
жить: живу жить живет 
весь: всей 
аналогичный: аналогичные 
площадка: площадки 
тариф: тарифам 
охват: охвату 
аудитория: аудитории аудитория 
ресурс: ресурсов 
гораздо: гораздо 
зато: зато 
собираться: собираются 
ценитель: ценители 
знаток: знатоки 
брать: берут 
комиссия: комиссии комиссию 
обязательно: обязательно 
уточнять: уточняйте 
размер: размер 
выставлять: выставлять выставят 
торги: торги 
барахолка: барахолки 
магазин: магазины 
подобный: подобных подобные 
быстрый: быстрый 
наименее: наименее 
недорогой: недорогие 
принимать: примут 
серьезный: серьезным 
дисконт: дисконтом 
скоро: скорее 
взять: взял возьмут 
реализация: реализацию 
отдавать: отдадут отдай 
бытовой: бытовая 
нумизматика: нумизматикой нумизматика 
сверхприбыльный: сверхприбыльный 
заработок: заработок 
хобби: хобби 
неторопливый: неторопливым 
инвестирование: инвестированием 
будущее: будущее 
разбогатеть: разбогатеете 
исключать: исключено 
машина: машину машиной 
сын: сын сына 
внук: внука 
трехлитровый: трехлитровая 
оставлять: оставьте оставили оставил 
тэг: тэги 
обложка: обложка 
анна: анна 
зиновьев: зиновьева 
редакция: редакция 
думать: думал думаете 
комментарий: комментарий комментарии 
проходить: проходят 
модерация: модерацию 
правило: правилам правила 
журнал: журнала 
артур: артур 
симонянин: симонян 
кажется: кажется 
нормальный: нормальная 
начинающий: начинающих 
автор: автора автор автору 
отвечать: ответить 
igor: igor 
vs: vs 
спасибо: спасибо 
полезный: полезную полезная 
статья: статьи статей статью статья 
andrey: andrey 
demin: demin 
собирать: собирать собирал собирающих собирает собрал собирала 
погодовка: погодовку погодовки 
дина: дина 
воробейка: воробейка 
держать: держал держим 
вода: воды воду 
фшок: фшоке 
кулаткин: кулаткин 
яковлевич: яковлевич 
вообще: вообще 
позабывать: позабыл 
поблагодарить: поблагодарить 
доступность: доступность 
она: её 
содержание: содержания 
родион: родион 
захаров: захаров 
всеволод: всеволод 
конец: конца 
читать: читай читать 
xatuna: xatuna 
calilova: calilova 
молодость: молодости 
иностранный: иностранным иностранные 
забросить: забросила 
ivan: ivan 
miroshnikov: miroshnikov 
лето: летом 
насобирать: насобирал 
бумажный: бумажные 
ирина: ирина 
ершов: ершова 
блин: блин 
сделать: сделала 
жалеть: жалею 
алексей: алексей 
ермолов: ермолов 
однажды: однажды 
везение: везение 
александр: александр 
хорошун: хорошун 
дмитрий: дмитрий 
сырой: сырое 
глупый: глупое 
замечание: замечание замечания 
уровень: уровне 
троллинг: троллинга 
детский: детского 
заказ: заказу 
собственный: собственному 
желание: желанию 
хотение: хотению 
щучий: щучьему 
веление: велению 
отчеканиться: отчеканится 
станок: станок 
решать: решил решает решили 
говорить: говорит говорите говоря 
дома: дома 
ремонт: ремонт ремонта 
понимать: понимают поймет 
рабочий: рабочие 
зинаида: зинаида 
обершты: обершт 
шкатулка: шкатулка 
николай: николай 
владимирович: владимирович 
звонить: звони звонить 
магнитный: магнитные 
прочий: прочие 
alexander: alexander 
mig: mig 
кремль: кремль 
татьяна: татьяна 
долгополова: долгополова 
копь: копей 
галя: галя 
стрелкова: стрелкова 
копа: коп 
ракета: ракетой 
еще: ещё 
потиченко: потиченко 
арсений: арсений 
нурлан: нурлан 
султан: султанов 
ожидать: ожидал 
прибыльно: прибыльно 
наталья: наталья 
банников: банникова 
огромный: огромными огромное 
жаль: жаль 
рано: раньше 
леонид: леонид 
рякин: рякин 
хороший: лучшие хорошее 
заниматься: заняться занимаюсь 
taki: taki 
bruh: bruh 
аватарка: аватарка 
герой: герой 
пытаться: пытается 
советский: советские советское советских 
прабабушка: прабабушки 
потратить: потратила 
вес: веса 
нелли: нелли 
добрый: добрый 
предлагать: предложить 
vasya: vasya 
litvinsev: litvinsev 
владимир: владимир 
кутин: кутин 
прошлое: прошлом 
дом: дом 
участок: участком 
сарай: сарае 
литровый: литровые 
наполнять: наполнена 
третий: третья 
эдак: эдак 
килограмм: килограмм 
село: селе 
девать: деть 
отделка: отделку 
пол: пол 
выкладывать: выкладывают 
ps: ps 
играть: играем 
сергей: сергей 
тиняков: тиняков 
неюбилейный: неюбилейные 
биржевой: биржевым 
язык: языком 
низкий: низкая низкого 
ликвидность: ликвидность 
факт: факт 
популярный: популярны популярное 
многое: многое 
состояние: состоянии состояния 
ходить: ходит 
терять: теряет 
товарный: товарный 
значит: значит 
двухсотлетний: двухсотлетние 
империя: империи 
сиделев: сиделев 
глупость: глупости 
ходовой: ходовые 
вещь: вещи вещь 
среда: среде 
крайне: крайне 
ликвидный: ликвидная 
элементарно: элементарно 
москва: москве 
петербург: петербурге 
возможно: возможно 
спрос: спрос 
профильный: профильных профильный 
лот: лоты 
висеть: висят 
месяц: месяцами 
сыктывкар: сыктывкаре 
абсолютно: абсолютно 
перекуп: перекупов 
гражданин: граждан 
плохо: плохо 
разбираться: разбирающихся разбирается 
неадекватный: неадекватной 
оценка: оценки оценкой 
сеть: сети 
учет: учета 
бумажник: бумажника 
точка: точки 
зрение: зрения 
совершенно: совершенно 
иной: иные 
доступный: доступный 
почта: почта 
многий: многих 
заинтересовывать: заинтересовать 
плохой: плохого 
сохрана: сохрана 
хлам: хлам 
убитый: убитые 
перекупщик: перекупщик 
торг: торга 
желающий: желающих 
полагать: положить 
коллекция: коллекцию 
вы: вами 
согласный: согласен 
возникать: возникали возникнут 
трудность: трудности 
входить: входит 
сфера: сферу 
интерес: интересов 
toria: toria 
ani: ani 
илья: илья 
саломатин: саломатин 
купюра: купюр купюра 
помнить: помню 
наличка: наличку 
захарин: захарин 
килограм: килограма 
алимпийский: алимпийских 
рублевак: рублевак 
petrov: petrov 
заголовок: заголовку 
биткоин: биткоин 
ekaterina: ekaterina 
stepnova: stepnova 
альбом: альбом альбомами 
начинаться: началось 
приходить: пришла 
почитать: почту 
документ: документы 
работа: работе 
крупный: крупная 
выгребать: выгребли 
толк: толку 
alex: alex 
классный: классные классная 
главное: главное 
комментатор: комментатор 
литр: литра 
надеяться: надеюсь 
доходить: дойдут 
перебирать: перебрать 
расходиться: разошлись 
партия: партиями 
сто: сто 
однокопеечный: однокопеечных 
банковский: банковский 
мешок: мешок 
идеальный: идеальном 
позволять: позволить 
запас: запасов 
хватить: хватит 
специфичный: специфичный 
порядок: порядок 
покупатель: покупателей покупателя 
ирис: ирис 
бабушка: бабушка 
смерть: смерти 
экспонат: экспонат 
банкнота: банкноты банкнота 
ребенок: дети детей 
подрастать: подрастут 
показывать: показывать 
расплачиваться: расплачивались 
прадедушка: прадедушки 
казахстан: казахстан 
белоруссия: белоруссии 
ссср: ссср 
старый: старые 
катар: катар 
китай: китай 
япония: япония 
впечатлять: впечатляю 
гость: гостей 
полька: полька 
ребристый: ребристые 
гладкий: гладкие 
интересно: интересно 
кроме: кроме 
kurmanbek: kurmanbek 
syrgabekov: syrgabekov 
истомин: истомина 
давно: давно 
бонистика: бонистикой 
дочь: дочь 
хотеть: хочет хочу 
богатство: богатство 
разлом: разломы 
штамп: штампа 
выкус: выкусы 
преревертыш: преревертыши 
чечевица: чечевица 
непропечатывать: непропечатанный 
гурт: гурт 
раз: разу 
удаваться: удалось 
аутентичный: аутентичные 
николаевский: николаевский 
золотник: золотник 
михаил: михаил 
захарченко: захарченко 
отредактировать: отредактировано 
закупать: закупает 
позвонить: позвоните 
детство: детстве 
удалять: удален 
пользователь: пользователем 
титов: титов 
кирилл: кирилл 
речь: речь 
мелочевка: мелочевку 
сдавать: сдаю 
аренда: аренду 
вкладывать: вложить 
искусство: искусство 
старинный: старинные 
книга: книги 
гравюра: гравюры 
зарабатывать: заработать 
драгметалл: драгметаллов 
новостройка: новостройкой 
покупка: покупки 
инвестор: инвестору 
долг: долг 
предприниматель: предпринимателю 
компания: компании 
мошенник: мошенникам 
понадобиться: понадобились 
справка: справки 
репетитор: репетитор 
полагаться: полагался 
каникулы: каникулы 
налог: налог налоги 
инвалидность: инвалидностью 
копить: копить 
балл: баллы 
уведомлять: уведомлять 
работник: работник 
поставлять: поставлять поставить 
работодатель: работодателю 
ипать: ип 
молодой: молодой 
оформлять: оформить 
риск: риски 
сотрудничать: сотрудничают 
сосед: соседи 
заливать: залили 
дверной: дверную 
ручка: ручку 
замок: замок 
клей: клеем 
протест: протест 
завещание: завещание 
муж: мужа 
имущество: имущество 
здание: здание 
баланс: баланс 
проблема: проблемы проблеме 
багаж: багажом 
поездка: поездках 
косметичка: косметичка 
уход: уход 
чувствительный: чувствительной 
комбинированный: комбинированной 
кожа: кожей 
акна: акне 
последствие: последствия 
вносить: внесет 
доля: доли 
обучение: обучение 
отрабатывать: отработала 
целевой: целевому 
договор: договор договору 
процент: проценты 
неделя: неделю 
посылка: посылка 
застревать: застряла 
таможня: таможне 
стаут: стауты 
гоза: гозе 
ламбик: ламбики 
пить: пить 
крафтовый: крафтовое 
пиво: пиво 
бали: бали 
зарплата: зарплатой 
въезд: въезда 
сербия: сербию 
россиянин: россиян 
мнение: мнение 
поколение: поколение 
девяностый: девяностых 
лишний: лишнее 
труд: труда 
беспроводный: беспроводные 
колонка: колонки 
удачный: удачных 
модель: моделей 
директор: директор 
розничный: розничной 
поволжье: поволжье 
экономист: экономист 
дежурный: дежурный 
электромонтер: электромонтер 
новосибирск: новосибирске 
тратить: тратила 
впечатление: впечатления 
apple: apple 
watch: watch 
вакансия: вакансии 
сообщать: сообщить 
проект: проекте 
контакт: контакты 
политика: политика 
конфиденциальность: конфиденциальности 
пользование: пользования 
ао: ао 
лицензия: лицензия 
