подконтрольный: подконтрольная 
солонин: солонину 
компания: компании компания компаний 
выкупать: выкуплено выкупает 
qiwi: qiwi 
frank: frank 
media: media 
data: data 
исследование: исследований исследование исследования 
карьера: карьера 
хронология: хронология 
минута: минуты 
назад: назад 
украина: украине украина 
вводить: ввела ввести 
санкция: санкции 
против: против 
московский: московской 
биржа: биржи 
сегодня: сегодня 
французский: французский 
societe: societe 
generale: generale 
продавать: продает 
последний: последний 
оставаться: оставшийся остаются 
россия: россия россии россией 
актив: активы актив активов 
вчера: вчера 
дерипаска: дерипаска 
взнос: взнос 
списывать: списать 
бизнес: бизнесу бизнес 
кредит: кредитов кредите кредиты 
госбанк: госбанках 
германия: германия 
замораживать: заморозила замороженных 
российский: российские российских российском российскую российского 
подсанкционный: подсанкционные 
сумма: сумму 
млрд: млрд 
евро: евро 
путин: путин 
разрешать: разрешил 
объединять: объединить 
дочерний: дочерних 
банка: банка 
ozon: ozon 
день: дня 
правительство: правительство 
выдвигать: выдвинуло 
шестеро: шестерых 
кандидат: кандидатов 
наблюдательный: наблюдательный 
совет: совет 
втб: втб 
raiffeisen: raiffeisen 
bank: bank 
international: international 
ограничивать: ограничил 
банк: банками банков банки банкам 
валютный: валютным валютных 
платеж: платежах платеж 
эмитент: эмитенты 
облигация: облигаций 
должный: должны 
быть: будут 
раскрывать: раскрывать 
информация: информации информацию 
апрель: апреля 
г: г 
инвестор: инвесторы 
получать: получили 
первый: первые 
отказ: отказы 
разблокировка: разблокировке 
ес: ес 
цб: цб 
предлагать: предлагает предложил предложить 
скорректировать: скорректировать 
расчет: расчет расчетов расчетах 
показатель: показателя 
долговой: долговой 
нагрузка: нагрузке 
рассылка: рассылки рассылка 
итог: итоги итоге итогам 
неделя: недели 
наш: нашим наш наша 
трактовка: трактовка 
основной: основными основных 
событие: событий 
банковский: банковских банковском 
рынок: рынке рынка 
подписываться: подписаться подпишитесь 
согласный: согласен 
условие: условиями условия 
обработка: обработки 
данный: данных 
грузия: грузии 
прошлый: прошлый 
год: год лет году года 
россиянин: россияне россиян 
открывать: открыли 
тысяча: тысяч 
счет: счетов счетах 
рассматривать: рассмотрит 
изменение: изменение 
лимит: лимита 
бесплатный: бесплатных 
перевод: переводов переводы 
сбп: сбп 
токен: токен 
использовать: использован 
внешнеторговый: внешнеторговых 
считать: считает 
правильный: правильным 
возврат: возврат 
финансовый: финансовых финансовые 
выплата: выплате 
дивиденд: дивидендов 
планировать: планирует 
опубликовывать: опубликовать 
расширять: расширенные 
стандарт: стандарты 
открытый: открытых 
api: api 
март: марта марте 
прибыль: прибыль 
georgia: georgia 
прошлое: прошлом 
вырастать: вырос выросла вырастет 
раз: раза 
число: число 
участник: участников 
аналог: аналога 
swift: swift 
приближаться: приблизилось 
увеличивать: увеличил 
страна: стран 
гк: гк 
выводить: вывести 
свой: свои свой 
ipo: ipo 
продажа: продажи 
долгов: долгов 
банкрот: банкротов 
умерший: умерших 
расти: растут 
фон: фоне 
падение: падения 
цена: цен цена 
телеграм: телеграме 
доллар: долларах долларов доллара 
мосбиржа: мосбирже 
пятница: пятницу 
момент: моменте 
достигать: достигала 
рубль: рублях рублей 
упрощать: упростить 
документооборот: документооборот 
иностранный: иностранными иностранные 
суд: суд 
заменять: заменил 
истец: истца 
дело: деле дело 
бинбанк: бинбанка 
финанс: финанс 
налаживать: наладил 
пополнение: пополнение 
клиентский: клиентских 
бывший: бывшего 
зампред: зампреда 
вернуть: вернули 
обратно: обратно 
генпрокуратура: генпрокуратуру 
миракян: миракяна 
покупать: покупает 
лизинговый: лизинговую 
deere: deere 
company: company 
карта: карты карт 
готовиться: готовятся 
принимать: принимать 
монголия: монголии 
freedom: freedom 
holding: holding 
тимур: тимура 
турлова: турлова 
американский: американский 
инвестбанк: инвестбанк 
maxim: maxim 
group: group 
почему: почему 
отказывать: отказывают 
заемщик: заемщикам 
фишинговый: фишинговые 
сайт: сайте сайты 
мочь: могут 
становиться: стать 
персонифицировать: персонифицированными 
цифра: цифра 
средний: средний 
ипотека: ипотека ипотеки ипотеке 
первичный: первичном 
тыс: тыс 
руб: руб 
поделиться: поделиться 
обсуждать: обсуждает 
поэтапный: поэтапное 
увеличение: увеличение 
имущественный: имущественного 
ценз: ценза 
квалинвестор: квалинвесторов 
хотеть: хочет 
ответственность: ответственность 
утечка: утечки 
клиент: клиентов 
конец: конце 
февраль: февраль февраля 
начинать: начнет начал 
размещение: размещение 
очередной: очередного 
выпуск: выпуска 
запускать: запустил 
приложение: приложения 
инвестиция: инвестиций инвестиции 
физический: физическое 
золото: золото 
брокер: брокер 
возглавлять: возглавил 
михаил: михаил 
белявский: белявский 
открытие: открытие 
набиуллина: набиуллина 
видеть: видит 
технологический: технологических 
риск: рисков 
работа: работе 
telegram: telegram 
заявлять: заявил 
рост: росте 
доля: доля доли 
безналичный: безналичных 
продлять: продлит 
ограничение: ограничения 
снятие: снятие 
наличный: наличной 
валюта: валюты 
накоплять: накопленный 
объем: объем 
рубеж: рубеж 
частный: частные частных 
покупатель: покупателями 
акция: акцию акций 
фрилансер: фрилансеров 
семь: семь 
исполнять: исполнять 
обязательство: обязательства 
госгарантия: госгарантиям 
выступать: выступил 
возмещение: возмещение 
потеря: потерь 
мошенник: мошенников 
euroclear: euroclear 
clearstream: clearstream 
привлекать: привлечь 
рассмотрение: рассмотрению 
иск: иска 
совершать: совершили 
сделка: сделок 
мало: меньше 
маркетплейс: маркетплейсы 
площадка: площадкой 
вторичный: вторичного 
обращение: обращении обращения 
цфа: цфа 
крупный: крупнейшие крупнейших 
убыток: убыток 
глава: глава 
всемирный: всемирного 
покидать: покидает 
пост: пост 
минфин: минфин 
бельгия: бельгии 
направлять: направлять 
ответ: ответы 
повод: поводу 
заблокировать: заблокированных 
турция: турции 
оаэ: оаэ 
вступать: вступить 
налоговый: налоговый 
обмен: обмен 
смочь: смогут 
ухудшать: ухудшать 
качество: качество 
мобилизовать: мобилизованным 
уралсиб: уралсиб 
ужесточить: ужесточит 
хранение: хранения 
недельный: недельная 
инфляция: инфляция 
замедляться: замедлилась 
январь: январе января 
юань: юаня 
международный: международных 
показывать: показала 
минимальный: минимальное 
значение: значение 
одобрять: одобрил 
создание: создание 
рабочий: рабочей 
группа: группы 
передача: передачи 
минцифра: минцифры 
призывать: призвало 
предоставлять: предоставлять 
услуга: услуги 
мессенджер: мессенджеры 
минюст: минюст 
швейцария: швейцарии 
признавать: признал 
незаконный: незаконным 
конфискация: конфискацию 
отключать: отключить 
росбанк: росбанк 
курс: курс 
превышать: превышал 
ddos: ddos 
смс: смс 
африка: африки 
рассказывать: рассказали 
кибератака: кибератаках 
ангелина: ангелина 
румянцев: румянцева 
такой: таким 
образ: образом 
сергей: сергея сергею 
солонина: солонина 
голос: голосов 
владелец: владельцу 
dalliance: dalliance 
services: services 
миноритарий: миноритариев 
млн: млн 
класс: класса 
составлять: составляет 
говориться: говорится 
центр: центра 
раскрытие: раскрытия 
проведение: проведения 
данна: данной 
оферта: оферте оферту оферты 
владеть: владеть 
около: около 
находиться: находящихся 
принадлежать: принадлежать 
ранее: ранее 
несколько: несколько 
объявлять: объявляла 
речь: речь 
идти: шла 
один: одну 
устанавливать: установлена 
фиксировать: фиксированная 
размер: размере 
статистика: статистика 
тема: теме темы 
июль: июле 
выставлять: выставила 
выкуп: выкуп 
vky: vky 
ads: ads 
бумага: бумагу 
соответствовать: соответствует 
находить: нашли 
ошибка: ошибку 
телегр: телеграм 
вклад: вклады 
наличные: наличными 
автокредит: автокредиты 
денежный: денежные 
зарплатный: зарплатные 
проект: проекты 
private: private 
banking: banking 
premium: premium 
малый: малый 
календарь: календарь 
rg: rg 
done: done 
periodic: periodic 
готовый: готовые 
отчет: отчет 
ситуация: ситуации 
кредитный: кредитные кредитных 
самый: самое 
полный: полное 
четвертый: четвертом 
квартал: квартале 
обзор: обзор 
калькулятор: калькулятором 
доходность: доходности 
читать: читайте 
также: также 
татьяна: татьяна 
воронова: воронова 
вятохо: вятохо 
редакция: редакция 
реклама: реклама 
партнерский: партнерские 
материал: материалы 
платформа: платформы 
youtube: youtube 
zen: zen 
вконтакте: вконтакте 
twitter: twitter 
linkedin: linkedin 
индекс: индекс 
frg: frg 
тег: теги 
финансы: финансы 
рф: рф 
мониторинг: мониторинги 
сервис: сервисы 
awards: awards 
credit: credit 
cards: cards 
mortgage: mortgage 
small: small 
business: business 
loans: loans 
auto: auto 
finance: finance 
payments: payments 
market: market 
payrolls: payrolls 
contact: contact 
centers: centers 
мероприятие: мероприятия 
персональный: персональные 
данные: данные 
политика: политика 
конфеденциальность: конфеденциальности 
сетевой: сетевое 
издание: издание 
зарегистрировать: зарегистрировано 
федеральный: федеральной 
служба: службе 
надзор: надзору 
сфера: сфере 
связь: связи 
информационный: информационных 
технология: технологий 
массовый: массовых 
коммуникация: коммуникаций 
ноябрь: ноября 
свидетельство: свидетельство 
регистрация: регистрации 
эл: эл 
фс: фс 
учредитель: учредитель 
юрий: юрий 
геннадьевич: геннадьевич 
грибанов: грибанов 
сергеевна: сергеевна 
отдельный: отдельные 
публикация: публикации 
содержать: содержать 
предназначать: предназначенную 
пользователь: пользователей 
контакт: контакты 
общий: общие 
вопрос: вопросы 
новость: новость 
москва: москва 
ленинградский: ленинградский 
бц: бц 
офис: офис 
главный: главная 
еще: ещё 
сообщать: сообщить 
опечатка: опечатке 
текст: текст 
который: который 
отправлять: отправлен отправить 
редактор: редакторам 
ваш: ваш 
комментарий: комментарий 
отмена: отмена 
