посылка: посылки посылка посылками посылкой посылке посылок посылку 
застревать: застрял застряла застрянет 
таможня: таможни таможня таможню таможне 
год: годы лет году года 
делать: делать делает 
узнавать: узнал узнать узнаете 
промой: промо 
бесплатный: бесплатная 
кредитка: кредитка 
промокод: промокоду 
fgo: fgo 
давать: дать давайте 
учебник: учебник 
сравнятор: сравнятор 
сообщество: сообщество 
ипотека: ипотека 
кредитный: кредитная 
история: история 
тест: тесты 
дневник: дневники дневник 
трата: траты трат трата 
налоговый: налоговые налоговую налоговый 
вычет: вычет 
написать: написанный напишите написать написано 
инвестиция: инвестиции 
бизнес: бизнес бизнеса 
разбор: разборы 
закон: законов 
калькулятор: калькуляторы 
путешествие: путешествия 
медицина: медицина 
здоровье: здоровье 
недвижимость: недвижимость 
подкаста: подкасты 
видео: видео 
смотреть: смотреть смотрит 
сервис: сервисы 
расчет: расчеты расчетом 
закладка: закладки 
письмо: письма письму письмо 
оставаться: оставайтесь 
деньги: деньгами деньги денег 
поток: потоки 
покупка: покупкой покупок покупка покупке покупки покупку 
инструкция: инструкция инструкции 
человек: человеком человека люди людьми людей человеку людям человек 
который: который которой которые которых которого которую которая котором которое 
ходить: ходит ходил 
работа: работу работы 
июль: июле 
проводить: провел провести проведете 
московский: московскому московской 
час: часа час часов часам 
выцарапывать: выцарапывая 
свой: свои свой своей 
граница: границу границы 
максим: максим 
ильях: ильяхов 
бывший: бывший 
главред: главред 
знать: знаем знаю 
лицо: лицо 
местный: местное местных 
инспектор: инспектора инспектору инспекторы инспектор инспектором инспекторам инспекторов 
приходить: пришли пришедшие приходит пришла прихожу приходило приходить пришло прийти 
подготовить: подготовленным 
мочь: могу могут 
решать: решил решить решит 
вопрос: вопросы 
быстро: быстро 
хотя: хотя 
первый: первой первым первую первого первый 
раз: раза 
получение: получения получении 
российский: российским российскую 
прочитывать: прочитать прочитайте 
заказывать: заказываю заказывал заказал заказываете заказываешь заказывали заказали 
какой: какие каким каких 
повод: поводам поводу поводов 
задерживать: задержали задержать задерживает задержит задержала задержана 
стоять: стоять стоит 
взять: возьмите взять возьмут 
себя: собой 
упрощать: упростите упростить 
жизнь: жизни жизнь 
очередь: очередь очереди очередью 
уплачивать: уплачены уплачивают уплачивать 
пошлина: пошлины пошлина пошлину 
общаться: общаться 
пойти: пойти 
связанный: связаны 
попадать: попасть попала 
россия: россии россию 
должный: должна должны 
преодолевать: преодолеть 
это: этим это 
специальный: специальное специальная специальную 
служба: службами служба службы 
следить: следить следит 
ввоз: ввоз ввоза ввозом ввозу 
вывоз: вывозом 
товар: товаров товара товар товары 
отделение: отделении отделениях отделение отделению отделения 
аэропорт: аэропортах аэропорту 
морской: морских 
порт: портах 
почтамт: почтамта почтамте почтамтах 
прилетать: прилетает прилетаете прилетит 
идти: идите идете 
коридор: коридору 
задача: задача 
ввозить: ввезли ввозить ввозил 
запрещать: запрещенное запрещенные запрещено запрещенного 
вывозить: вывезли 
ценный: ценного 
нужный: нужны нужные нужен нужна 
международный: международного международная 
проходить: проходят прошла прошли проходить пройти проходило проходит 
касаться: касается 
исключение: исключения 
отправлять: отправил отправленных отправят отправили отправит отправить отправила отправляют 
курьерский: курьерскими 
таможенник: таможенникам таможенник таможенника таможеннику 
проверять: проверьте проверяла проверяет проверить 
содержимое: содержимое содержимого 
рентген: рентгене 
документ: документам документы документом документов документ 
лично: лично 
порядок: порядок порядке 
пропускать: пропускает 
далеко: дальше 
страна: страну 
большинство: большинстве 
случай: случаев случаях случае 
происходить: произойдут происходит 
незаметно: незаметно 
просто: просто 
получать: получить получала получаем получаю получен получать получили получают получаете 
вид: виде 
выпускать: выпустить 
приглашать: пригласят пригласить 
получатель: получателя 
разговор: разговор 
потеряться: потерялась 
почему: почему 
наш: наши нашу нашем наших 
скоро: скорее 
один: одной одна одного одним одно одну 
три: трех 
подозрение: подозрение 
коммерческий: коммерческое коммерческий коммерческая 
задекларировать: задекларирован 
частный: частная 
понимать: понял понимать понять 
находиться: находится 
требоваться: требуется 
пояснение: пояснение пояснения 
этот: эта этих этими 
разъяснение: разъяснение разъяснения 
вводить: введены вводите 
ограничение: ограничений ограничения 
порнуха: порнуху 
экстремистский: экстремистскую 
литература: литературу 
фильм: фильмы 
аудиокнига: аудиокниги 
оружие: оружие 
патрон: патроны 
опасный: опасные 
вещество: вещества 
наркотик: наркотики 
сырье: сырье 
орган: органах органы 
кровь: кровь 
электрооборудование: электрооборудование 
вылов: вылова 
рыба: рыбы 
тонкий: тонкие 
рыболовный: рыболовные 
сеть: сети 
любой: любую любом 
электроника: электронику 
возможность: возможности 
шифрование: шифрования 
нотификация: нотификацию 
рация: рации 
высокочастотный: высокочастотные 
передатчик: передатчики 
генератор: генераторы 
сигнал: сигналов 
редкий: редкая редких 
зверушка: зверушек 
растение: растения растений 
некоторые: некоторые 
средство: средства 
защита: защиты 
ко: ко 
ваш: вашей вашим ваша ваши ваше вашу 
два: две двумя 
вещь: вещи вещей вещь 
видно: видно 
готовый: готова готовым 
выдача: выдачи выдаче 
обычно: обычно 
незнакомый: незнакомом 
место: место месте месту мест 
москва: москве москву 
варшавский: варшавском 
шоссе: шоссе 
ехать: ехать 
туда: туда 
пока: пока 
нужно: нужно 
время: время времени 
вариант: вариант 
трекинг: трекинге 
таможенный: таможенного таможенной таможенным таможенных таможенный 
уведомление: уведомления уведомление уведомлением уведомлению 
заказной: заказное 
доставка: доставка доставки доставкой доставке 
конверт: конверте 
шаблонный: шаблонное 
мол: мол 
приезжать: приехало приезжать приезжайте 
милый: милая милейший 
причина: причины 
задержка: задержки 
указывать: указать указаны указал 
быть: будут будьте 
расплывчатый: расплывчатое 
разный: разных разные разного 
прикладывать: приложил приложат 
трек: трек треку треком 
вес: весом веса 
срок: срок срока сроком 
хранение: хранения 
собирать: соберите собирать собирайте 
готовиться: готовиться готовьтесь 
отпрашиваться: отпроситься 
плохо: плохо 
дело: дело 
петербург: петербурге 
направлять: направила 
мой: моими мою моего мои моим 
день: дня день дни дней днях 
упасть: упадет 
призывать: призывает 
вообще: вообще 
проблема: проблемы проблема проблеме 
обращать: обратите 
внимание: внимание 
истекать: истекает истечет истечь 
опасность: опасность 
приход: прихода приходом 
фактический: фактическим 
выпуск: выпуском 
пройти: пройдет 
приходиться: приходилось придется пришлось 
дополнительный: дополнительные 
успевать: успеваю успеют 
принимать: принимают принять 
обратно: обратно 
заявление: заявление 
продление: продление 
визит: визит 
откладывать: отложить откладывать 
устраивать: устроена устроило устроить 
почта: почта почте почты 
плохой: худшему 
брать: брать берут 
присылать: прислали 
основание: основание 
вы: вами 
говорить: говорить говоря говорил говорят говорит 
отдавать: отдать отдаете 
выдавать: выдавать выдадут 
нормально: нормально 
копия: копии копия копию копиям 
паспорт: паспорт паспортов паспорта 
страница: страницы страниц 
регистрация: регистрации 
понадобиться: понадобились понадобится 
навредить: навредит 
иметь: имеют имеем иметь 
несколько: несколько 
запас: запасе 
интернет: интернет интернета 
бывать: бывает 
трудно: трудно 
останавливаться: остановиться 
варшавка: варшавке варшавку 
ксерокс: ксерокс 
прямо: прямо 
р: р 
родственник: родственники родственников 
член: членов 
семья: семью семьи 
потребоваться: потребуются 
доказывать: доказать 
продажа: продажу 
родной: родным 
должно: должно 
понятно: понятно 
непонятно: непонятно 
устанавливать: устанавливают установите 
родство: родство 
свидетельство: свидетельства 
брак: браке 
рождение: рождении 
подтверждение: подтверждения подтверждение 
инвойс: инвойсу инвойса инвойс 
оплата: оплаты оплату 
скачиваться: скачивается 
сайт: сайту сайт сайтом сайте сайта 
магазин: магазины магазина магазин 
чек: чеку чек 
оплачивать: оплатить оплачивал оплачивали 
именно: именно 
описание: описания описание 
лежать: лежит 
объяснять: объяснить 
картинка: картинками картинка 
подходить: подойдут подойдет подходил 
фотография: фотографии фотографий 
распечатка: распечатка распечатки 
все: всеми всем всему всё 
конкретный: конкретную конкретные конкретной конкретный 
прошлый: прошлый 
десяток: десяток 
большой: большим большом 
интерес: интересом 
изучать: изучил изучите 
спрашивать: спрашивал спрашивает 
работать: работает работали работают работаете работать 
очень: очень 
помогать: помогло поможет помоги помогли помогите 
бытовой: бытовых 
термос: термос 
чай: чай чая 
перекус: перекус 
запросто: запросто 
выходить: выйдет выйти выходить 
выпивать: выпить 
кофе: кофе 
автомат: автомат автомата 
предпочитать: предпочитаю 
свое: свое 
набор: набор 
яркий: ярких яркая яркий 
наклейка: наклеек 
необычный: необычный 
маркер: маркер 
удивляться: удивитесь 
пригождаться: пригодятся 
бросать: бросьте 
сумка: сумку 
планшет: планшет 
ноутбук: ноутбук 
питание: питание 
он: нему 
сделать: сделать сделал сделала 
двухдневный: двухдневный 
объем: объем 
степан: степану 
наблюдение: наблюдениям 
мобильный: мобильный 
ловить: ловит 
планировать: планировали 
сериал: сериалы 
заранее: заранее 
скачать: скачать 
расширение: расширение 
приемный: приемные 
варшавкев: варшавкев 
пятница: пятницу 
суббота: субботы субботу 
короткий: короткий 
четверг: четверг 
обед: обед 
технологический: технологический 
перерыв: перерыв 
около: около 
поэтому: поэтому 
девять: девяти 
утро: утра утром 
половина: половине 
восьмой: восьмого 
понедельник: понедельник 
гарантированный: гарантированно 
ждать: ждать ждал ждете ждите 
заканчиваться: закончится 
смысл: смысла смысл 
просиживать: просидите 
вечер: вечера 
обслуживать: обслужат 
везти: повезло 
пустой: пуст пустой 
зал: зале зал 
полный: полный полную полной полная 
ад: ад 
цивилизованный: цивилизованное 
рассказывать: расскажу расскажите 
тот: те тех той теми 
хороший: лучшие лучшем 
дюжина: дюжина 
окно: окон окна окнами 
хватать: хватает 
персонал: персонала 
двигаться: движется 
медленно: медленно 
табло: табло 
электронный: электронная электронной 
висеть: висит висят 
всякий: всякий 
живой: живую живой живая 
особенность: особенность 
чудовищно: чудовищно 
часто: чаще часто 
уходить: уходят ушло ушел 
дождаться: дождавшись 
порядочный: порядочные 
познакомить: познакомив 
они: ними 
середина: середины 
молча: молча 
сдаваться: сдаются 
находить: найти находит найдите 
конец: концов 
кто: кем кого 
начинаться: начинается начинаются 
вопль: вопли 
истерика: истерики 
размахивание: размахивание 
рука: руками руках 
лимит: лимит лимита 
беспошлинный: беспошлинного беспошлинный 
продлять: продлили 
апрель: апреля 
совет: совет советов 
листочек: листочках 
номер: номером номера 
раздавать: раздайте 
обязанный: обязаны 
жест: жестом 
сильно: сильно 
бумажка: бумажка 
спокойно: спокойно 
чувствовать: чувствует 
никто: никого никто 
я: мной 
занимать: занимал 
молодой: молодой 
держаться: держитесь 
женщина: женщины 
красный: красном 
наводить: навел 
поблагодарить: поблагодарят 
следующий: следующие следующий 
спокойствие: спокойствии 
душно: душно 
возле: возле 
информационный: информационного 
стенд: стенда 
панель: панель 
кондиционер: кондиционера 
нажимать: нажмите 
кнопка: кнопку 
становиться: станет 
легко: легче 
превращать: превращает 
душегубка: душегубку 
довольно: довольно 
приятный: приятное 
уплата: уплата уплату 
вероятный: вероятное 
развитие: развитие 
событие: событий 
дорогой: дороже дорогое дорогую 
превышать: превышающую превышающими превысили 
превышение: превышения 
доплачивать: доплатить 
доплата: доплатой 
дешево: дешевле 
беспошлинно: беспошлинно 
стоимость: стоимость стоимостью стоимости 
кг: кг 
установленный: установлен 
отправление: отправление 
разбивать: разбить 
желательно: желательно 
интервал: интервалом 
рассматриваться: рассматриваться 
составлять: составляет составить составит 
начисляться: начисляется 
сумма: сумма суммы сумму 
менее: менее 
килограмм: килограмм 
например: например 
купить: купил купили купить 
браслет: браслет 
разделять: разделить 
вряд: вряд 
получаться: получится 
платить: платил платят платить платите 
размер: размер 
доставлять: доставить доставляет доставлять 
почтовый: почтовом 
попросить: попросить попросят 
предъявлять: предъявить 
инн: инн 
иностранец: иностранцам 
достаточно: достаточно 
берет: берет 
комиссия: комиссии комиссию 
налагать: наложенного 
платеж: платежа 
посредник: посредники посредник 
самостоятельно: самостоятельно 
перевести: переведете 
отправка: отправки 
также: также 
начинать: начинает начали начинали начала 
задавать: задавать 
просить: просить 
показывать: показывайте 
приготавливать: приготовили 
никакой: никаких никакого 
глаз: глаза 
видеть: видел 
увидеть: увидит 
предлагать: предложить 
открывать: открывает открыть открывать 
убеждаться: убедиться 
сам: сама сами самому 
склад: склад складе 
этаж: этажами 
ниже: ниже 
другой: другому другие 
попадаться: попасться попадались 
спокойный: спокойными 
методичный: методичными 
дружелюбный: дружелюбными 
тщательно: тщательно 
разъяснять: разъясняли 
хамить: хамили 
огрызаться: огрызались 
долгий: долгого 
ожидание: ожидания 
обреченно: обреченно 
разводить: разводили 
адский: адского 
совок: совка 
хамство: хамства 
встречать: встретил 
постоянно: постоянно 
жаловаться: жаловаться жаловались 
изменение: изменения 
правило: правила правилам правил 
неточный: неточные 
бумага: бумагами бумаги бумаг 
регламент: регламенту регламентами 
соблюдать: соблюсти 
формальность: формальности 
нарушать: нарушит 
ошибаться: ошибется ошибаться 
итог: итоге 
мы: нам 
правильно: правильно 
действие: действия 
ожидать: ожидает 
постараться: постарайтесь 
максимум: максимум максимуму 
переносить: перенося 
договариваться: договориться договоритесь 
прийти: придете придет 
минута: минут 
завтра: завтра 
вместо: вместо 
таинственный: таинственный 
отдел: отдел 
слышать: слышал 
возвращаться: возвращались 
разбирательство: разбирательство 
раздосадовать: раздосадованы 
каждый: каждой каждый 
новый: новых новый 
требовать: требует требовал 
упоминать: упоминать 
слово: слов слова словами 
партия: партия 
аудиозапись: аудиозапись 
проверка: проверку 
компьютер: компьютер 
микроконтроллер: микроконтроллер 
помалкивать: помалкивайте 
немой: нем 
зашифровывать: зашифровать 
шутить: шутить 
представлять: представьте 
сколько: сколько 
шутка: шутку 
психовать: психовал психовать 
истерить: истерить 
сидеть: сидела сидит 
стекло: стеклом 
переживание: переживания 
лампочка: лампочки 
затягиваться: затянется 
коллега: коллегам 
тормозить: тормозите 
весь: весь 
процесс: процесс 
народный: народный 
суд: суд 
сходить: сходить 
истечение: истечения 
возвращать: возвращают 
удерживать: удерживают 
сохранять: сохранить 
разум: разум 
добавлять: добавьте 
личный: личный 
кабинет: кабинет 
курс: курсе 
судьба: судьбы 
пропустить: пропустите 
момент: момент 
дергаться: дергайтесь 
официальный: официальное 
наличка: наличку 
мыслимый: мыслимые 
число: числе 
выписка: выписку 
банка: банка 
скриншот: скриншоты 
распечатывать: распечатайте распечатать 
поездка: поездках поездкой 
десять: десять 
лишний: лишних лишнее 
потратить: потратить потратила 
поход: походы 
организовывать: организуйте 
предварительно: предварительно 
провоцировать: провоцируйте 
тэг: тэги 
государство: государство 
обложка: обложка 
анна: анна 
зиновьев: зиновьева 
комментарий: комментарии 
модерация: модерацию 
журнал: журнала 
михаил: михаил 
милюков: милюков 
статья: статьи статье статья 
устаревать: устарела 
евро: евро 
месяц: месяца месяц месяцев 
отвечать: ответить 
никита: никита 
юкович: юкович 
главный: главный 
редактор: редактор 
спасибо: спасибо 
обновлять: обновили обновляли 
актуальный: актуальная 
ilya: ilya 
gindin: gindin 
герой: герой 
шардины: шардин 
автор: автора автором автор автору 
продолжать: продолжает 
действовать: действовать 
павел: павел 
левин: левин 
отредактировать: отредактировано 
неее: неее 
kalan: kalan 
информация: информация информацию 
январь: январь 
сегодня: сегодня 
посещать: посетить 
здание: здания здание 
часы: часы 
потихоньку: потихоньку 
появляться: появляться 
хватить: хватило 
необходимо: необходимо 
талон: талон 
е: ё 
маленький: маленький 
терминал: терминал 
неочевидно: неочевидно 
располагать: расположен 
окошко: окошко окошку 
открываться: открывается 
пара: пару 
указанный: указанные 
живо: живо 
интересовать: интересуют 
полениться: поленился поленитесь 
напечатать: напечатал 
вроде: вроде 
главное: главном 
позволять: позволяющий 
печатать: печатать 
копировать: копировать 
оказываться: оказалась оказалось 
качество: качестве 
цена: цену 
рождественский: рождественской 
скидка: скидки 
объяснение: объяснений объяснение объяснения объяснениями 
расхождение: расхождения 
изначальный: изначальной 
беседа: беседы 
бланк: бланка 
дача: дачи 
сдача: сдачи 
самый: самая самых самой 
завершение: завершения 
оформление: оформления 
финальный: финальных 
подход: подходами 
оформлять: оформить оформляла 
банковский: банковской 
карта: картой карту 
еще: ещё 
способ: способ 
телефон: телефона 
сторонний: стороннего 
провайдер: провайдера 
рядом: рядом 
интересоваться: интересовался 
итого: итого 
общение: общение 
далее: далее 
подождать: подождать 
выезжать: выедет 
недра: недр 
смочь: смогли смогу 
сказать: сказали сказала 
ездить: ездить 
сотрудник: сотрудники 
удивлять: удивлены 
вызов: вызовом 
шатилов: шатилов 
законный: законно 
писать: пишут писал писали 
следовать: следует 
помнить: помнить 
наценка: наценки 
незаконный: незаконны 
такой: такая таким такое таких такие такую 
роспотребнадзор: роспотребнадзор 
бабак: бабака 
кавайка: кавайка 
чот: чот 
коммент: коммент 
вылезать: вылезла 
новость: новостях 
февраль: феврале 
игорь: игорь 
букин: букин 
ростов: ростове 
брокер: брокер 
опинтер: опинтер 
уезжать: уезжает 
китай: китай китая 
ответ: ответа 
привет: привета 
алиэкспресс: алиэкспресс 
магнитола: магнитола 
последний: последнее 
сообщение: сообщение 
отслеживание: отслеживания отслеживании отслеживанию 
приземляться: приземлился 
прошествие: прошествии 
прицепляться: прицепилась 
людмила: людмила 
нел: нел 
обновление: обновление 
лето: летом 
ровно: ровно 
позвать: позвали 
крутить: крути 
равно: равно 
отличие: отличие 
водить: водили 
сверять: сверяли 
список: список 
фотографировать: фотографировали 
пр: пр 
бегать: бегала 
заполнять: заполняла 
огромный: огромное 
действительно: действительно 
приносить: принести 
дома: дома 
ксер: ксеры 
заказ: заказа заказе 
ирина: ирина 
алексеева: алексеева 
униха: уних 
выходной: выходные 
elena: elena 
arsentyeva: arsentyeva 
здравствовать: здравствуйте 
постамат: постамат 
результат: результате 
суетиться: суетиться 
бежать: бежать 
выяснять: выяснять 
kate: kate 
tkalina: tkalina 
владивосток: владивостоке 
мск: мск 
статус: статус статусе 
alejandro: alejandro 
esquire: esquire 
нахождение: нахождение 
некоторый: некоторое 
направляться: направиться 
надежда: надежда 
каменский: каменских 
спор: спор 
сразу: сразу 
долго: дольше долго 
тень: тени 
век: век 
выпрашивать: выпросил 
ерунда: ерунда 
косметика: косметика 
подумать: подумали 
передумывать: передумала 
горд: гордов 
короче: короче 
забывать: забыть 
рубеж: рубежа рубежом 
ибо: ибо 
отправляться: отправляться 
ради: ради 
сбор: сборов 
дистанционный: дистанционную 
налаживать: наладить 
рад: рад 
пусть: пусть 
подавиться: подавятся 
лишь: лишь 
палка: палки 
колесо: колеса 
вставлять: вставляли 
рф: рф 
пора: порой 
производить: производят 
востребованно: востребованно 
легально: легально 
user: user 
уважаемый: уважаемые 
германия: германии 
дочь: дочери 
праздник: празднику 
тормознуть: тормознули тормознула 
конфета: конфеты 
обращаться: обратиться 
жить: живу живет живешь 
липецкий: липецкая 
обл: обл 
dg: dg 
matvei: matvei 
shein: shein 
снова: снова 
карпун: карпун 
эх: эх 
неактуальный: неактуально 
знакомый: знакомыми 
sergey: sergey 
alekseev: alekseev 
вновь: вновь 
налог: налога налог налоги 
irina: irina 
shalbanova: shalbanova 
думать: думаю 
сестра: сестра 
личн: личн 
польза: польз 
курьерс: курьерс 
позвонить: позвонили 
пост: пост 
разбираться: разбираться 
надеяться: надеюсь 
малыш: малышом 
наездиться: наездишься 
даль: даль 
max: max 
maxoff: maxoff 
подарок: подарком подарок 
она: её 
оценивать: оценить оценивают 
опытный: опытные 
продавец: продавцом продавцы продавцу продавец 
образ: образом 
прикапываться: прикапывалась 
списываться: списаться 
ньюанс: ньюансах 
пересылка: пересылку 
либо: либо 
едьте: едьте 
ебануть: ебанутых 
б: б 
образец: образец 
объяснительный: объяснительной 
реально: реально 
полиция: полиция 
опергруппа: опергруппа 
рекомендовать: рекомендуем рекомендую 
внимательно: внимательно 
комментирование: комментирования 
дмитрий: дмитрий 
саутина: саутин 
сахаровский: сахаровская 
таможка: таможку 
закрыват: закрывате 
polishko: polishko 
дважды: дважды 
неделя: недели неделю 
требование: требованию 
отсылать: отсылал 
скан: скан 
звонить: звонил 
подтверждать: подтверждали 
слава: слава 
юнитрейт: юнитрейт 
переставать: перестаньте 
ругать: ругать 
почитать: почту 
вспоминать: вспоминаю 
теплота: теплотой 
sturm: sturm 
de: de 
mets: mets 
общий: общем 
мелочь: мелочь 
штука: штук 
позиция: позиции 
настоятельно: настоятельно 
пользоваться: пользоваться 
пункт: пункты 
пятерочка: пятерочки 
прочее: прочее 
доходить: дойдет 
иначе: иначе 
развертывать: развернут 
прохождение: прохождении 
контроль: контроля 
брелок: брелков 
отказывать: отказано 
смеяться: смеялась 
заголовок: заголовком 
экономия: экономии 
учитывать: учитывая 
шедевральный: шедеврально 
али: али 
нск: нск 
бывалый: бывалых 
александр: александр 
трофимов: трофимов 
количество: количество 
ограничивать: ограничено 
лакрез: лакрез 
онлоп: онлоп 
специфический: специфический 
юрлица: юрлица 
proforma: proforma 
invoice: invoice 
переводить: перевел 
счет: счет счетах 
тк: тк 
ссылка: ссылки ссылкой ссылку 
подтерждение: подтерждение 
отсканировать: отсканированная 
квитанция: квитанция 
перечисление: перечислении 
достаточный: достаточны 
существовать: существует 
зарубежный: зарубежного 
аналогичный: аналогичного 
обыскивать: обыскал 
прежде: прежде 
анжелика: анжелика 
трекномер: трекномеру 
растоможка: растоможка 
движение: движений 
поступать: поступить 
данна: данной 
ситуация: ситуации ситуация 
владимир: владимир 
дружинин: дружинин 
март: марта 
тишина: тишина 
илья: илья 
паланский: паланский 
американский: американской 
отик: отик 
приложение: приложение 
физлицо: физлица 
антон: антон 
каширин: каширин 
подсказывать: подскажите 
подтвердить: подтвердив 
онлайн: онлайн 
иван: иван 
остальной: остальные 
любовь: любовь 
awb: awb 
домодедово: домодедово 
дата: дата 
агент: агентом 
glamych: glamych 
ввод: ввода 
заново: заново 
женя: женя 
борисов: борисова 
пожалуйста: пожалуйста 
останавливать: остановила остановлена 
подозревать: подозревают 
использование: использование 
компания: компания 
dpd: dpd 
накладная: накладной 
бензогенератор: бензогенератора 
запчасть: запчасть 
электромобиль: электромобилю 
гибридный: гибридному 
бензиновый: бензиновый 
двигатель: двигатель 
судя: судя 
данил: данил 
луконин: луконин 
интересный: интереснее 
процессор: процессор 
алик: алика 
благополучно: благополучно 
китайский: китайскому китайской 
октябрь: октября 
изменяться: изменился 
сторона: стороны 
энтузиазм: энтузиазма 
мало: мало 
павлов: павлов 
близко: ближе 
отправитель: отправителю 
пономарев: пономарев 
хм: хм 
причем: причем 
метка: метки 
тема: теме 
шопинг: шопинга 
покупать: покупать 
бояться: боюсь 
привязывать: привязывать 
убер: уберам 
америка: америке 
экономить: экономить 
вернуть: вернуть 
мошенник: мошенникам 
справка: справки 
репетитор: репетитор 
полагаться: полагался 
каникулы: каникулы 
инвалидность: инвалидностью 
копить: копить 
балл: баллы 
уведомлять: уведомлять 
белоруссия: белоруссии 
работник: работник 
поставлять: поставлять поставить 
работодатель: работодателю 
ипать: ип 
хотеть: хочет 
машина: машину 
риск: риски 
сотрудничать: сотрудничают 
иностранный: иностранным 
сосед: соседи 
заливать: залили 
дверной: дверную 
ручка: ручку 
замок: замок 
клей: клеем 
протест: протест 
ремонт: ремонта 
завещание: завещание 
ребенок: дети детей 
муж: мужа 
имущество: имущество 
баланс: баланс 
багаж: багажом 
возникать: возникали 
косметичка: косметичка 
уход: уход 
чувствительный: чувствительной 
комбинированный: комбинированной 
кожа: кожей 
акна: акне 
последствие: последствия 
покупатель: покупателя 
вносить: внесет 
доля: доли 
обучение: обучение 
отрабатывать: отработала 
целевой: целевому 
договор: договор договору 
процент: проценты 
популярный: популярное 
стаут: стауты 
гоза: гозе 
ламбик: ламбики 
пить: пить 
крафтовый: крафтовое 
пиво: пиво 
бали: бали 
зарплата: зарплатой 
въезд: въезда 
сербия: сербию 
россиянин: россиян 
мнение: мнение 
поколение: поколение 
девяностый: девяностых 
рынок: рынке 
труд: труда 
беспроводный: беспроводные 
колонка: колонки 
удачный: удачных 
модель: моделей 
директор: директор 
розничный: розничной 
поволжье: поволжье 
экономист: экономист 
дежурный: дежурный 
электромонтер: электромонтер 
новосибирск: новосибирске 
тратить: тратила 
классный: классные 
впечатление: впечатления 
apple: apple 
watch: watch 
вакансия: вакансии 
сообщать: сообщить 
проект: проекте 
контакт: контакты 
политика: политика 
конфиденциальность: конфиденциальности 
пользование: пользования 
ао: ао 
банк: банк 
лицензия: лицензия 
