сериал: сериале сериалы сериал сериала 
взвод: взводе 
битва: битва 
uber: uber 
сюжет: сюжета сюжет 
актер: актеры актеров 
отличие: отличие 
реальность: реальности 
промой: промо 
дарить: дарит 
акция: акции акций 
регистрация: регистрацию 
мочь: могут могу могли могла мог 
получать: получать получить получает получили 
учебник: учебник 
сравнятор: сравнятор 
сообщество: сообщество 
ипотека: ипотека 
кредитный: кредитная 
история: историю история истории 
тест: тесты 
дневник: дневники дневник 
трата: траты трат 
налоговый: налоговые налоговую налоговый 
вычет: вычет 
написать: написать написана 
инвестиция: инвестиции инвестициях инвестициями 
бизнес: бизнес бизнеса 
разбор: разборы 
закон: законов 
калькулятор: калькуляторы 
путешествие: путешествия 
медицина: медицина 
здоровье: здоровье 
недвижимость: недвижимость 
подкаста: подкасты 
видео: видео 
смотреть: смотрел смотреть 
сервис: сервисах сервис сервисе сервисы 
расчет: расчеты 
закладка: закладки 
письмо: письма 
оставаться: остается оставайтесь 
деньги: деньгами деньги денег 
поток: потоки 
правда: правда 
неправда: неправда 
купить: купив купить 
lyft: lyft 
inc: inc 
партнерство: партнерстве 
тинькофф: тинькофф 
котировка: котировки 
обновляться: обновляются 
минута: минут 
год: год году лет года годах 
американский: американский американского американском американское 
канал: канале 
showtime: showtime 
выходить: вышла выйти вышел вышедшем 
рассказывать: рассказывающий рассказывает расскажите 
компания: компаний компании компанию компанией компаниях компания 
основание: основания 
ipo: ipo 
решать: решают решили 
разбирать: разобранный разобрать разбираем 
точка: точки 
зрение: зрения 
достоверность: достоверности 
насколько: насколько 
похожий: похожи похожий похож 
свой: свои свой своей 
прототип: прототипы 
реальный: реальных реальной реальном реальное 
жизнь: жизнь жизни 
какой: какие 
момент: моментов момента моменты момент 
описывать: описал 
довольно: довольно 
точно: точно 
изменяться: изменились 
поживать: поживает 
настоящий: настоящий настоящая 
сегодня: сегодня 
тема: темы тему 
автор: авторы автор автора 
обходить: обошли обходят 
сторона: стороной стороны 
михаил: михаил 
городилов: городилов 
любить: любит 
кино: кино 
профиль: профиль 
внимание: внимание 
спойлер: спойлеры 
материал: материала материал 
содержать: содержит 
описание: описании описание 
важный: важных важные 
часть: частей части 
основатель: основатели основатель основателями 
ubercab: ubercab 
трэвис: трэвис 
каланик: калаником каланика каланик 
знакомиться: знакомится 
венчурный: венчурных венчурными венчурным 
инвестор: инвестора инвесторы инвесторов инвесторам инвестором 
билл: билл биллом 
герль: герли 
чандлер: чандлер 
впечатлевать: впечатленный 
талант: талантом 
напористость: напористостью 
инвестировать: инвестировал инвестирует 
поскольку: поскольку 
водитель: водитель водителями водителям водителей водители водителем водителю 
выступать: выступают 
лицензировать: лицензированными 
таксист: таксистом таксисты таксистов таксистам таксистами 
муниципалитет: муниципалитетами муниципалитетах муниципалитет 
который: который которые которых которой которого которая котором 
работать: работать работают работает 
выкатывать: выкатывают 
огромный: огромные 
штраф: штрафов штрафы 
избегать: избежала избежать избегать 
перерегистрировать: перерегистрирует 
извоз: извоз извозом 
поездка: поездках поездок 
это: это 
оказываться: оказываются оказаться оказывается оказалось 
лишь: лишь 
временной: временной 
мера: мерой 
поэтому: поэтому 
запускать: запускает 
программа: программу 
greyball: greyball 
отмечать: отмечает отметить 
помогать: помогает помогают 
время: времени временем 
путем: путем 
лоббизм: лоббизма 
руководство: руководства руководство 
лицензия: лицензии лицензия 
работа: работу работы работами 
крупный: крупнейшем крупнейших 
сначала: сначала 
сша: сша 
больший: большей большего 
мир: мира миру мир 
параллельно: параллельно 
зреть: зреют 
корпоративный: корпоративные корпоративной 
скандал: скандалы скандал скандалов 
вокруг: вокруг 
первый: первые первый 
становиться: становятся становится стать станут 
недовольный: недовольнее 
доход: доходы доходов 
падать: падают 
ужесточение: ужесточения 
финансовый: финансовой 
политика: политика политики политикой 
перерабатывать: перерабатывать 
приходиться: приходится 
противоположность: противоположностью 
альтернативный: альтернативный 
условие: условий условия 
легко: полегче 
вообще: вообще 
относиться: относятся 
человечный: человечнее 
беда: беды 
показывать: показывают показан показана показывает показано показаны 
разный: разных разные 
персонаж: персонажами персонажей персонажах персонаж 
уделять: уделено 
фаузи: фаузи 
камель: камелем камелю 
опасаться: опасаются 
расти: растут растущей 
популярность: популярности 
среди: среди 
пользователь: пользователями пользователи пользователей 
пытаться: пытаются 
агрессивность: агрессивность 
вызывать: вызывают вызывает 
отторжение: отторжение 
переговоры: переговоры переговоров 
проваливаться: проваливаются 
появляться: появляется 
трещина: трещина 
отношение: отношениях отношения 
второй: второй 
касаться: касаются касается 
культура: культуры 
женщина: женщины 
подвергаться: подвергаются 
дискриминация: дискриминации 
несколько: несколько нескольких 
уровень: уровень уровнях 
домогаться: домогаются 
коллега: коллеги 
решение: решению решении 
повышение: повышении повышения 
случай: случай случаях случае 
пример: примере 
зритель: зрителю зрителям 
программистка: программистка 
писательница: писательница 
сьюзен: сьюзен 
фаулер: фаулер 
домогательство: домогательствами домогательств 
защищать: защищены защитить 
ключевой: ключевые 
сотрудница: сотрудницы 
юрист: юрист 
гил: гил 
пьянь: пьяни 
лапать: лапает 
остин: остин 
гейдт: гейдт 
отвечать: отвечает ответить 
привлечение: привлечение 
новый: новых новый 
курс: курсе 
проблема: проблемой проблемы проблем проблемами проблеме 
считать: считает 
ради: ради 
высокий: высшей высокие 
цель: цели целях 
развитие: развития 
потерпеть: потерпеть 
третий: третьего третий 
связанный: связан 
нарушение: нарушением 
приватность: приватности 
iphone: iphone 
доходить: доходит 
глава: глава 
apple: apple 
тим: тим 
кук: куком кук 
лично: лично 
заниматься: занимается 
грозить: грозит 
удалять: удалить 
приложение: приложении приложение 
app: app 
store: store 
повлечь: повлечет 
потеря: потерю 
ход: ходе 
интенсивный: интенсивных 
ситуация: ситуацию ситуация 
удаваться: удается 
урегулировать: урегулировать 
четвертый: четвертую четвертый 
правоконсервативный: правоконсервативный 
кандидат: кандидат 
дональд: дональд 
трамп: трампа трамп 
выигрывать: выигрывает 
президентский: президентские 
выборы: выборы 
общество: общество 
резко: резко 
поляризоваться: поляризуется 
политический: политическому политическом 
признак: признаку 
пиар: пиара 
советник: советником 
экономический: экономической экономическую экономическим 
вопрос: вопросам 
встречать: встречает 
непонимание: непонимание 
столько: столько 
сколько: сколько 
сотрудник: сотрудников 
доминировать: доминируют 
леволиберальный: леволиберальные 
настроение: настроения 
достигать: достигает 
запрещать: запрещает 
въезд: въезд въезда 
страна: стран страну 
житель: жителей жителям 
ряд: ряда 
мусульманский: мусульманских 
аэропорт: аэропорты аэропорту аэропорта 
начинаться: начинается 
забастовка: забастовка 
человек: людей люди человеку человек 
выезжать: выехать 
приостанавливать: приостанавливает 
действие: действия действие 
механизм: механизма 
цена: цены цена 
перевозка: перевозки 
делать: делать делает делал 
завоевание: завоевания 
доля: доли долей 
рынок: рынок рынке рынка 
ущерб: ущерб 
обычный: обычным обычных 
протест: протест протесты 
внутри: внутри 
рассматриваться: рассматриваются 
именно: именно 
контекст: контексте 
приводить: приводит приведя 
волна: волне волну 
удаление: удалений удаление 
пятый: пятый 
тянуться: тянется 
перманентный: перманентно 
чистый: чистого 
темпераментный: темпераментный 
постоянно: постоянно 
антагонизировать: антагонизирует 
представитель: представителей 
пресса: прессы прессе 
способствовать: способствует 
ухудшение: ухудшению 
новостной: новостного 
фон: фоне фона 
публицист: публицистов 
занимать: занимают занимает 
проактивный: проактивную 
позиция: позицию 
один: одной 
указанный: указанных 
обращать: обратить 
накапливаться: накапливается накопившиеся 
связь: связи 
повлиять: повлиять 
успех: успех успеха 
вести: ведет 
суперагрессивный: суперагрессивно 
эскалировать: эскалирует 
конфликт: конфликт 
медленно: медленно 
неуклонно: неуклонно 
ухудшаться: ухудшаются 
продолжать: продолжает 
успешно: успешно 
расширяться: расширяться 
совет: совете совета 
директор: директоров директора директор 
известный: известные 
успешный: успешные 
арианна: арианна арианну 
хаффингтон: хаффингтон 
турман: турман 
соосновательница: соосновательница 
huffington: huffington 
post: post 
близкий: близким 
друг: другом 
соратник: соратником 
вскоре: вскоре 
критический: критическая 
масса: масса 
срыв: срыв 
другой: другие 
член: члены 
готовиться: готовящегося 
назначать: назначить 
козел: козлом 
отпущение: отпущения 
убирать: убрать 
пост: поста 
главный: главного главный главные 
долго: долго 
упорно: упорно 
сопротивляться: сопротивляется 
итог: итоге 
соглашаться: соглашается 
уходить: уйти 
также: также 
вместе: вместе 
вынуждать: вынуждают 
покидать: покинуть 
ассоциироваться: ассоциируется 
утешать: утешают 
миллиардер: миллиардерами 
основывать: основана основан 
одноименный: одноименном 
нехудожественный: нехудожественного нехудожественном 
труд: труде труда 
super: super 
pumped: pumped 
battle: battle 
журналист: журналиста 
майка: майка 
айзек: айзека айзек 
книга: книги книга 
писать: писал 
new: new 
york: york 
times: times 
сказать: сказал 
немалый: немалой 
степень: степени 
статья: статьи статьях 
издание: издании 
ранее: ранее 
мы: нам нами 
художественный: художественная 
экранизация: экранизация 
произведение: произведения 
отдельный: отдельные 
фильм: фильме фильм 
драматизировать: драматизированы 
интересный: интереснее интересными 
гигант: гигантов 
netflix: netflix 
spotify: spotify 
периодически: периодически 
показываться: показывается 
фантазия: фантазий 
допускать: допустим 
полюбовно: полюбовно 
расставаться: расстался 
партнерша: партнершей 
картинка: картинка 
исчезать: исчезает 
зеленый: зеленом 
синий: синем 
случаться: случилось 
обычно: обычно 
плохо: хуже 
говорить: говорит говорят 
сериальный: сериальные сериальный 
богатый: богат 
визуальный: визуальную 
составлять: составляющую составить 
анимированный: анимированные 
надпись: надписи 
экран: экране 
мультяшный: мультяшные 
компьютерный: компьютерные 
фрагмент: фрагменты 
герой: герой герои 
ломать: ломают 
стена: стену 
обращаться: обращаются 
напрямую: напрямую 
закадровый: закадровый 
повествователь: повествователь 
личность: личность 
устанавливать: установлена 
голос: голос 
принадлежать: принадлежит 
великий: великому 
режиссер: режиссеру 
квентин: квентину 
тарантино: тарантино 
факт: факт 
кстати: кстати 
никак: никак 
обыгрываться: обыгрывается 
узнавать: узнал 
субтитр: субтитрами 
слух: слуха 
подписывать: подписывают подписал 
имя: имена 
несмотря: несмотря 
клиповый: клиповую клиповой 
форма: форму формы 
целое: целом 
обо: обо 
событие: событиях 
выход: выхода 
действительно: действительно 
использовать: использовала использовать 
уклонение: уклонения 
чиновник: чиновников 
хотя: хотя 
слово: слово словам 
нужный: нужен 
враждебно: враждебно 
настроенный: настроенных настроенной 
всплывать: всплыла 
поспешить: поспешила 
честный: честное 
удивительный: удивительным 
образ: образом 
судебный: судебных 
иск: исков 
чиновничий: чиновничьих 
ведомство: ведомств 
леволиберально: леволиберально 
публика: публикой 
поругаться: поругался 
насчет: насчет 
низкий: низких низкая низкие 
общий: общем 
доступ: доступе 
кампания: кампанией 
против: против 
сексизм: сексизма 
играть: играет играют играла 
примерно: примерно 
тот: тех ту 
роль: роль 
подруга: подруга 
защитница: защитница 
определенный: определенного 
позвать: позвали 
медийный: медийную 
место: месте местами мест 
легендарный: легендарная 
телеведущая: телеведущая 
опра: опра 
уинфри: уинфри 
источник: источником источник 
emma: emma 
trim: trim 
rita: rita 
quinn: quinn 
contributor: contributor 
elizabeth: elizabeth 
morris: morris 
networks: networks 
david: david 
shankbone: shankbone 
wikipedia: wikipedia 
основное: основном 
мелочь: мелочи 
приписывать: приписывает 
идея: идею 
создание: создания 
изначальный: изначального 
гаррет: гаррета 
кэмп: кэмпа 
такой: такая таких такого такую 
заполнять: заполнил 
мусор: мусором 
куча: кучу 
пустой: пустых 
картонный: картонных 
коробок: коробок 
поставлять: поставил поставлять поставить 
мэрия: мэрии мэрией 
якобы: якобы 
лежать: лежали 
петиция: петиции петиций 
разрешение: разрешения разрешении 
город: городе 
свидетельство: свидетельством 
казаться: казалось 
тысяча: тысяча 
коробка: коробки 
наполнять: наполнены 
бутылка: бутылками 
вода: воды водой 
самый: самое самый 
значительный: значительный 
недостоверный: недостоверный 
взгляд: взгляд 
вымышленный: вымышленный 
приставание: приставаниях 
обвинять: обвиняли 
шервин: шервина 
пишевар: пишевара 
хотеться: хотелось 
например: например 
тощий: тощий 
очень: очень 
парадоксальный: парадоксальным 
кайло: кайл 
непохожесть: непохожесть 
минус: минус 
per: per 
se: se 
justin: justin 
sullivan: sullivan 
getty: getty 
images: images 
brian: brian 
ach: ach 
fortune: fortune 
прожиточный: прожиточного 
минимум: минимум минимума 
идти: идут 
дело: дел дела делом 
настоящее: настоящего 
торговаться: торгуется 
биржа: бирже 
согласно: согласно 
отчет: отчеты отчету отчет 
месяц: месяцев 
выручка: выручки выручка выручку 
разделяться: разделяется 
сегмент: сегментов сегмента 
стараться: старается стараюсь 
структура: структуры 
ориентироваться: ориентироваться 
последний: последний последние 
годовой: годовой 
возможный: возможны 
сезонный: сезонные 
флуктуация: флуктуации 
активность: активности 
особый: особый 
сильно: сильно 
проседать: просела 
коронакризис: коронакризиса 
продажа: продаж 
опора: опорой 
результат: результаты 
этот: эта этих 
объективный: объективной 
репрезентативный: репрезентативны 
пандемия: пандемия 
волшебный: волшебным 
заканчиваться: закончилась 
смог: смог 
наращивать: нарастить 
исторический: исторических 
максимум: максимумов 
быть: будут будем 
хороший: хорошей лучшие лучшее 
неделя: неделю 
ваш: вашей 
почта: почте 
каждый: каждый 
понедельник: понедельник 
бесплатно: бесплатно 
подписываться: подписаться подписывайтесь 
мобильность: мобильность 
любой: любой 
автовладелец: автовладелец 
смочь: смогли сможет 
соблюдение: соблюдении 
некоторые: некоторые некоторых 
несложный: несложных 
зарегистрироваться: зарегистрировавшись 
процент: процентов процент процентах проценты 
пассажир: пассажиры 
платить: платить платил платят 
скорректировать: скорректированная 
ebitda: ebitda 
доставка: доставка 
еда: еды 
ресторан: ресторанов 
груз: грузов грузы 
грузовик: грузовиков 
зарегистрировать: зарегистрированных 
заказ: заказу 
логистический: логистических 
убыточный: убыточной убыточный 
прибыль: прибыль 
миллиард: миллиардах 
доллар: долларов 
итоговый: итоговая 
маржа: маржа 
macrotrends: macrotrends 
враг: враг 
безработица: безработица 
зарплата: зарплатой зарплаты 
демотивировать: демотивирует 
потенциальный: потенциальных 
мешать: мешает 
оптимизировать: оптимизировать 
издержки: издержки 
давать: давая давайте дает 
отчетность: отчетности 
скрывать: скрыть 
положение: положение 
мошеннический: мошеннической 
математика: математикой 
прибыльный: прибыльный 
рискованный: рискованной 
убыточность: убыточность 
особенно: особенно 
страшный: страшна 
ставка: ставки 
заем: займам 
дополнительный: дополнительным 
ликвидность: ликвидности 
аналогичный: аналогичных 
тип: типа 
didi: didi 
стоимость: стоимость стоимости 
осень: осенью 
минувший: минувшего 
оцениваться: оценивалась 
район: районе 
млрд: млрд 
пора: пор 
утекать: утекло 
упасть: упала упасть упали 
влияние: влияние влиянием 
негативный: негативной негативное 
биржевой: биржевой 
конъюнктура: конъюнктуры 
теоретически: теоретически 
рассуждать: рассуждал 
двойной: двойном 
обзор: обзоре 
маловероятный: маловероятно 
регулятор: регуляторы 
одобрять: одобрят 
сделка: сделку 
презентация: презентация 
слайд: слайд 
вместо: вместо 
заключение: заключения 
яркий: яркий 
вульгарный: вульгарный 
тупой: тупой 
сам: само самого самих 
накачивать: накачанного 
стартап: стартапа стартап 
самодовольный: самодовольными 
наглый: наглыми 
критика: критики 
низко: пониже низко 
оценивать: оценили 
некоторый: некоторой 
карикатурность: карикатурности 
подача: подача 
уместный: уместна 
исходный: исходная 
выдавать: выдать 
батюшка: батюшка 
родион: родион 
романович: романович 
стоить: стоило 
подсвечивать: подсветить 
аморальность: аморальность 
создавать: создали 
практически: практически 
шанс: шансов 
сбагривать: сбагрили 
обогащаться: обогатившись 
млн: млн 
февраль: феврале 
здорово: здорово 
ранний: ранние 
зарабатывать: зарабатывает заработать зарабатывать 
благодаря: благодаря 
теория: теории 
дурак: дурака 
менее: менее 
сомнительный: сомнительным 
мероприятие: мероприятием 
отражать: отражают отражен 
оно: оно 
провальный: провальным 
начало: начале 
ниже: ниже 
изначально: изначально 
хотеть: хотят хотели хочет 
размещение: размещения 
считаться: считается 
провал: провалом 
игнорировать: игнорирует 
фактически: фактически 
выглядеть: выглядит 
въезжать: въехать 
набирать: набрать 
число: числе 
бонус: бонусы 
комиссия: комиссии 
демпинговать: демпинговать 
суд: судов 
мобилизовать: мобилизовать 
лоббист: лоббистов 
борьба: борьбы 
захватить: захватив 
повышать: повысить 
жалкий: жалкому 
состояние: состоянию 
стратегия: стратегия 
фрагментарно: фрагментарно 
неравномерно: неравномерно 
терпеть: терпела терпит 
убыток: убытки 
отрицательный: отрицательная 
исчисляться: исчисляется 
десяток: десятками 
проговариваться: проговаривается 
вскользь: вскользь 
подымать: поднять 
удачно: удачно 
называть: назвал 
деятельность: деятельность 
подобный: подобных 
стиль: стиль стиля 
миллениал: миллениалов 
разрушительный: разрушительные 
последствие: последствия 
массовый: массовой 
рецепция: рецепции 
надрываться: надрывающихся 
гроши: гроши 
час: часов час 
среднее: среднем 
многие: многие 
ездить: ездят 
день: день 
минимальный: минимальная 
почасовой: почасовая 
оплата: оплата 
нужно: нужно 
топливо: топливо 
техосмотр: техосмотр 
ремонт: ремонт ремонта 
транспорт: транспорта 
вещь: вещи 
кроме: кроме 
пострадать: пострадавшие 
лондон: лондоне 
лицензированный: лицензированных 
достаточно: достаточно 
обеспечивать: обеспечивать 
семья: семье 
средний: среднего 
класс: класса 
заполонять: заполонили 
происходить: произошло происходящего 
все: всему 
сдавать: сдавали 
сложный: сложные 
экзамен: экзамены 
лондонский: лондонские 
кэбмен: кэбмены 
брать: брали 
целевой: целевые целевому 
кредит: кредиты 
отчаяние: отчаяния 
кончать: кончают 
самоубийство: самоубийством 
раз: разу 
интерес: интересах 
потребитель: потребителей 
такси: такси 
должный: должны 
отказываться: отказаться 
услуга: услуг 
переходить: перейти 
традиционный: традиционные традиционных 
дорогой: дорогие 
таксопарк: таксопарки 
моральный: моральную 
яростно: яростно 
порицать: порицая 
поддерживать: поддержал 
запрет: запрет 
логично: логично 
добавлять: добавить 
перспектива: перспективу 
сходить: сойдет 
искать: ищете 
краткий: краткий 
емкий: емкий 
пересказ: пересказ 
план: плане 
суховато: суховато 
драма: драмы 
стартапа: стартапы 
посмотреть: посмотрите 
нетфликсовский: нетфликсовский 
классный: классные классными 
актерский: актерскими 
последить: последить 
срабатывать: сработало 
wework: wework 
новость: новости 
наш: нашем 
тэг: тэги 
фотография: фотография 
обложка: обложке 
комментарий: комментарии 
проходить: проходят 
модерация: модерацию 
правило: правилам правила 
журнал: журнала 
алексей: алексей 
петров: петров 
забавно: забавно 
снимать: снять 
яндекс: яндекс 
процветать: процветающий 
соцсеть: соцсетях 
срач: срач 
обманывать: обманывает 
раб: рабы 
кругом: кругом 
алибек: алибеки 
бороться: бороться 
нормальный: нормальные 
зажраться: зажрались 
бомбить: бомбить 
меняться: меняются 
константин: константин 
чегем: чегемов 
смущать: смутили 
постоянный: постоянные 
коучинговый: коучинговые 
ля: ля 
тоня: тони 
робинсоновский: робинсоновские 
мотивационой: мотивационые 
речь: речи 
неужели: неужели 
разговаривать: разговаривать 
нравиться: нравится 
дешевый: дешевой 
пластиковый: пластиковой 
фаллософия: фаллософией 
мышление: мышления 
ненароком: ненароком 
башка: башке 
мошенник: мошенникам 
понадобиться: понадобились 
справка: справки 
репетитор: репетитор 
полагаться: полагался 
каникулы: каникулы 
налог: налог налоги 
инвалидность: инвалидностью 
копить: копить 
покупать: покупать 
балл: баллы 
уведомлять: уведомлять 
счет: счет счетах 
белоруссия: белоруссии 
работник: работник 
товар: товары 
работодатель: работодателю 
ипать: ип 
молодой: молодой 
оформлять: оформить 
машина: машину 
риск: риски 
сотрудничать: сотрудничают 
иностранный: иностранным 
сосед: соседи 
заливать: залили 
дверной: дверную 
ручка: ручку 
замок: замок 
клей: клеем 
завещание: завещание 
ребенок: дети детей 
муж: мужа 
имущество: имущество 
здание: здание 
баланс: баланс 
багаж: багажом 
возникать: возникали 
косметичка: косметичка 
уход: уход 
чувствительный: чувствительной 
комбинированный: комбинированной 
кожа: кожей 
акна: акне 
покупатель: покупателя 
продавец: продавец 
вносить: внесет 
вернуть: вернуть 
обучение: обучение 
отрабатывать: отработала 
срок: срок 
договор: договор договору 
популярный: популярное 
посылка: посылка 
застревать: застряла 
таможня: таможне 
стаут: стауты 
гоза: гозе 
ламбик: ламбики 
пить: пить 
крафтовый: крафтовое 
пиво: пиво 
москва: москве 
жить: живет 
бали: бали 
сербия: сербию 
россиянин: россиян 
мнение: мнение 
поколение: поколение 
девяностый: девяностых 
лишний: лишнее 
беспроводный: беспроводные 
колонка: колонки 
удачный: удачных 
модель: моделей 
розничный: розничной 
сеть: сети 
поволжье: поволжье 
экономист: экономист 
дежурный: дежурный 
электромонтер: электромонтер 
новосибирск: новосибирске 
тратить: тратила 
впечатление: впечатления 
watch: watch 
вакансия: вакансии 
сообщать: сообщить 
проект: проекте 
контакт: контакты 
конфиденциальность: конфиденциальности 
пользование: пользования 
сайт: сайтом 
ао: ао 
банк: банк 
